state,PC,candidate_name,party,evm_votes,postal_votes,total_votes,Rank
Andhra Pradesh,Adilabad ,GODAM NAGESH,Telangana Rashtra Samithi,425762,5085,430847,1
Andhra Pradesh,Adilabad ,NARESH,Indian National Congress,257994,1563,259557,2
Andhra Pradesh,Adilabad ,RAMESH RATHOD,Telugu Desam,182879,1319,184198,3
Andhra Pradesh,Adilabad ,RATHOD SADASHIV,Bahujan Samaj Party,94363,57,94420,4
Andhra Pradesh,Adilabad ,NETHAWATH RAMDAS,Independent,41028,4,41032,5
Andhra Pradesh,Adilabad ,PAWAR KRISHNA,Independent,5051,4,5055,6
Andhra Pradesh,Adilabad ,BANKA SAHADEV,Independent,4780,7,4787,7
Andhra Pradesh,Adilabad ,MOSALI CHINNAIAH,Independent,8842,17,8859,8
Andhra Pradesh,Adilabad ,None of the Above,NOTA,17021,63,17084,9
Andhra Pradesh,Peddapalle ,DR.JANAPATI SARAT BABU,Telugu Desam,63174,160,63334,1
Andhra Pradesh,Peddapalle ,TAGARAM SHANKAR LAL,Bahujan Samaj Party,9430,19,9449,2
Andhra Pradesh,Peddapalle ,BALKA SUMAN,Telangana Rashtra Samithi,563214,2282,565496,3
Andhra Pradesh,Peddapalle ,G. VIVEKANAND,Indian National Congress,273441,897,274338,4
Andhra Pradesh,Peddapalle ,KALVALA SHANKAR,Pyramid Party of India,9288,2,9290,5
Andhra Pradesh,Peddapalle ,KALVALA SANJEEV,Republican Party of India,8609,0,8609,6
Andhra Pradesh,Peddapalle ,BOTHA VENKATA MALLAIAH,BCUF,2245,0,2245,7
Andhra Pradesh,Peddapalle ,J.V. RAJU,New India Party,3020,0,3020,8
Andhra Pradesh,Peddapalle ,VENKATA SWAMY INJAM,MaSP,3861,5,3866,9
Andhra Pradesh,Peddapalle ,VELTHURU MALLAIAH,Republican Paksha (Khoripa),45976,1,45977,10
Andhra Pradesh,Peddapalle ,KAMILLA JAYA RAO,Independent,2741,1,2742,11
Andhra Pradesh,Peddapalle ,GADDALA VINAY KUMAR,Independent,3263,3,3266,12
Andhra Pradesh,Peddapalle ,GORRE RAMESH,Independent,2359,2,2361,13
Andhra Pradesh,Peddapalle ,JINNA RAMADEVI,Independent,9199,0,9199,14
Andhra Pradesh,Peddapalle ,THALLAPALLI SRINIVAS,Independent,3698,1,3699,15
Andhra Pradesh,Peddapalle ,BUPELLI NARAYANA,Independent,7255,3,7258,16
Andhra Pradesh,Peddapalle ,MOUTAM RAVINDER,Independent,2671,3,2674,17
Andhra Pradesh,Peddapalle ,None of the Above,NOTA,5344,17,5361,18
Andhra Pradesh,Karimnagar ,CHENNAMANENI VIDYA SAGAR RAO,Bharatiya Janata Party,213836,992,214828,1
Andhra Pradesh,Karimnagar ,PONNAM PRABHAKAR,Indian National Congress,298386,2320,300706,2
Andhra Pradesh,Karimnagar ,BURLA. RAVI,Nationalist Congress Party,4768,1,4769,3
Andhra Pradesh,Karimnagar ,B. LAXMAN,Bahujan Samaj Party,11289,39,11328,4
Andhra Pradesh,Karimnagar ,VINOD KUMAR BOINAPALLY,Telangana Rashtra Samithi,503197,2161,505358,5
Andhra Pradesh,Karimnagar ,DR.DHARMAIAH VENDAVETLA,Bahujan Mukti Party,3771,1,3772,6
Andhra Pradesh,Karimnagar ,L. PRABHAKAR REDDY,Pyramid Party of India,3942,1,3943,7
Andhra Pradesh,Karimnagar ,MEESALA RAJI REDDY,Yuvajana Sramika Rythu Congress Party,3071,4,3075,8
Andhra Pradesh,Karimnagar ,RANAVENI LAKSHMAN,New India Party,2061,1,2062,9
Andhra Pradesh,Karimnagar ,REDDI MALLA SRINIVAS,Republican Party of India (A),8033,1,8034,10
Andhra Pradesh,Karimnagar ,SHAIK MAHMOOD,Welfare Party of India,39300,8,39308,11
Andhra Pradesh,Karimnagar ,UPPULETI.LAXMAN,Independent,2445,0,2445,12
Andhra Pradesh,Karimnagar ,KANDEM PRABHAKAR,Independent,4727,1,4728,13
Andhra Pradesh,Karimnagar ,PULIKOTA RAMESH,Independent,1772,1,1773,14
Andhra Pradesh,Karimnagar ,MALLESH YADAV BARLA,Independent,2757,0,2757,15
Andhra Pradesh,Karimnagar ,MOHAMMED AMJAD MOHIUDDIN,Independent,6713,0,6713,16
Andhra Pradesh,Karimnagar ,SRINIVAS REDDY LINGAMPALLY,Independent,3851,0,3851,17
Andhra Pradesh,Karimnagar ,None of the Above,NOTA,5722,12,5734,18
Andhra Pradesh,Nizamabad,ENDALA LAKSHMINARAYANA,Bharatiya Janata Party,222876,2457,225333,1
Andhra Pradesh,Nizamabad,KALVAKUNTLA KAVITHA,Telangana Rashtra Samithi,435706,3601,439307,2
Andhra Pradesh,Nizamabad,TALARI RAMULU,Bahujan Samaj Party,7398,23,7421,3
Andhra Pradesh,Nizamabad,MADHU YASKHI GOUD,Indian National Congress,270948,1175,272123,4
Andhra Pradesh,Nizamabad,ABDUL GANI,BCUF,4791,0,4791,5
Andhra Pradesh,Nizamabad,BANJA VEERAPPA,Pyramid Party of India,3649,2,3651,6
Andhra Pradesh,Nizamabad,MALIK MOHTASIM KHAN,Welfare Party of India,43738,76,43814,7
Andhra Pradesh,Nizamabad,RAPELLY SRINIVAS,Aam Aadmi Party,2613,8,2621,8
Andhra Pradesh,Nizamabad,SAGAR SUDDALA,Bahujan Mukti Party,1952,26,1978,9
Andhra Pradesh,Nizamabad,SINGAREDDY RAVINDRA REDDY,Yuvajana Sramika Rythu Congress Party,3508,21,3529,10
Andhra Pradesh,Nizamabad,ABDUL KAREEM KHAN (BABU),Independent,1599,2,1601,11
Andhra Pradesh,Nizamabad,KANDEM PRABHAKAR,Independent,3988,2,3990,12
Andhra Pradesh,Nizamabad,KOTAPATI NARSIMHAM NAIDU,Independent,2458,4,2462,13
Andhra Pradesh,Nizamabad,S. CHANDRAIAH,Independent,2817,0,2817,14
Andhra Pradesh,Nizamabad,CHIRULINGADRULA VENKATESHAM,Independent,3091,0,3091,15
Andhra Pradesh,Nizamabad,BAGWAN B,Independent,8129,0,8129,16
Andhra Pradesh,Nizamabad,None of the Above,NOTA,7244,22,7266,17
Andhra Pradesh,Zahirabad,B.B. PATIL,Telangana Rashtra Samithi,505983,2678,508661,1
Andhra Pradesh,Zahirabad,K.MADAN MOHAN RAO,Telugu Desam,156807,690,157497,2
Andhra Pradesh,Zahirabad,SYED FEROZUDDIN,Bahujan Samaj Party,8165,15,8180,3
Andhra Pradesh,Zahirabad,SURESH KUMAR SHETKAR,Indian National Congress,362939,1091,364030,4
Andhra Pradesh,Zahirabad,MARRI DURGESH,Republican Party of India (A),18027,0,18027,5
Andhra Pradesh,Zahirabad,MAHMOOD MOHIUDDIN,Yuvajana Sramika Rythu Congress Party,12369,14,12383,6
Andhra Pradesh,Zahirabad,DR. SUNEEL KUMAR CHOWDHARY,Aam Aadmi Party,3270,15,3285,7
Andhra Pradesh,Zahirabad,TANDALE AMBAJI RAO,Independent,2321,2,2323,8
Andhra Pradesh,Zahirabad,BENJAMIN RAJU,Independent,4802,2,4804,9
Andhra Pradesh,Zahirabad,RAMA RAO,Independent,4426,0,4426,10
Andhra Pradesh,Zahirabad,None of the Above,NOTA,11157,33,11190,11
Andhra Pradesh,Medak,KALVAKUNTLA CHANDRASEKHAR RAO,Telangana Rashtra Samithi,655484,2008,657492,1
Andhra Pradesh,Medak,CHAGANLA NARENDRA NATH,Bharatiya Janata Party,181177,627,181804,2
Andhra Pradesh,Medak,Y. SHANKAR GOUD,Bahujan Samaj Party,6633,10,6643,3
Andhra Pradesh,Medak,DR.P. SHRAVAN KUMAR REDDY,Indian National Congress,260202,261,260463,4
Andhra Pradesh,Medak,IQBAL ALI ZAFAR,Majlis Bachao Tahreek,5010,0,5010,5
Andhra Pradesh,Medak,KOMPELLI PRABHUDAS,Republican Party of India (A),7599,0,7599,6
Andhra Pradesh,Medak,"PRABHUGOUD, PULLAIAHGARI",Yuvajana Sramika Rythu Congress Party,11744,8,11752,7
Andhra Pradesh,Medak,BOMMA BALESHAM,Pyramid Party of India,3296,1,3297,8
Andhra Pradesh,Medak,KUNDETI. RAVI.,Independent,33507,0,33507,9
Andhra Pradesh,Medak,GAJABINKAR BANSILAL,Independent,3281,0,3281,10
Andhra Pradesh,Medak,GURJADA BHEERAIAH YADAV,Independent,2050,3,2053,11
Andhra Pradesh,Medak,BALARAJU MITTAPALLY,Independent,2973,0,2973,12
Andhra Pradesh,Medak,MEKA. SUBBA RAO,Independent,4441,0,4441,13
Andhra Pradesh,Medak,None of the Above,NOTA,10687,9,10696,14
Andhra Pradesh,Malkajgiri,KARUNAKAR.R,Bahujan Samaj Party,6111,22,6133,1
Andhra Pradesh,Malkajgiri,CH.MALLA REDDY,Telugu Desam,522423,933,523356,2
Andhra Pradesh,Malkajgiri,SARVEY SATHYANARAYANA,Indian National Congress,232989,541,233530,3
Andhra Pradesh,Malkajgiri,HANUMANTH RAO MYNAMPALLY,Telangana Rashtra Samithi,493433,1757,495190,4
Andhra Pradesh,Malkajgiri,DR.JAYAPRAKASH  NARAYAN .N,Lok Seva Parishad,157530,718,158248,5
Andhra Pradesh,Malkajgiri,JAJULA BHASKAR,SHP,7951,2,7953,6
Andhra Pradesh,Malkajgiri,V.DINESH REDDY,Yuvajana Sramika Rythu Congress Party,114941,280,115221,7
Andhra Pradesh,Malkajgiri,DIVAKAR DHARANIKOTA SUDHAKAR,All India Majlis-E-Ittehadul Muslimeen,18535,9,18544,8
Andhra Pradesh,Malkajgiri,PADURI SRINIVAS REDDY,TLP,793,9,802,9
Andhra Pradesh,Malkajgiri,BANDI SUDHAKAR,Jai Samaikyandhra Party,4088,7,4095,10
Andhra Pradesh,Malkajgiri,MURARI.T.N,Shivsena,1388,2,1390,11
Andhra Pradesh,Malkajgiri,SATHYANARAYANA YAADAV PEDDIBOYINA,BCBDP,593,3,596,12
Andhra Pradesh,Malkajgiri,SUTHARAPU PADMAIAH,APRSSP,527,2,529,13
Andhra Pradesh,Malkajgiri,DR.N.V.SUDHA KIRAN,Aam Aadmi Party,8264,37,8301,14
Andhra Pradesh,Malkajgiri,SURAKANTI VENKAT REDDY,Pyramid Party of India,2048,1,2049,15
Andhra Pradesh,Malkajgiri,ANJANEYULU.E,Independent,2675,2,2677,16
Andhra Pradesh,Malkajgiri,KANTE SAYANNA,Independent,2260,1,2261,17
Andhra Pradesh,Malkajgiri,KOYALKAR BHOJ RAJ,Independent,1547,0,1547,18
Andhra Pradesh,Malkajgiri,GAJABINKAR BANSILAL,Independent,1416,0,1416,19
Andhra Pradesh,Malkajgiri,DASARI BHARATH REDDY,Independent,1693,0,1693,20
Andhra Pradesh,Malkajgiri,PROF. K.NAGESHWAR,Independent,13037,202,13239,21
Andhra Pradesh,Malkajgiri,M.NAGESWARA RAO,Independent,1264,37,1301,22
Andhra Pradesh,Malkajgiri,PEESARI SATISH REDDY,Independent,1325,0,1325,23
Andhra Pradesh,Malkajgiri,POTTURI TULASI DAS,Independent,411,0,411,24
Andhra Pradesh,Malkajgiri,POLISETTY KRISHNA RAO,Independent,495,1,496,25
Andhra Pradesh,Malkajgiri,D.BIKSHAPATHI,Independent,5715,2,5717,26
Andhra Pradesh,Malkajgiri,RAHUL PANDIT,Independent,897,2,899,27
Andhra Pradesh,Malkajgiri,VATTIKUTI RAMARAO GOUD,Independent,1031,1,1032,28
Andhra Pradesh,Malkajgiri,M.T.VARUGHESE,Independent,1025,1,1026,29
Andhra Pradesh,Malkajgiri,B.VEERA HANUMANTHA REDDY,Independent,775,0,775,30
Andhra Pradesh,Malkajgiri,None of the Above,NOTA,8666,26,8692,31
Andhra Pradesh,Secundrabad,M.ANJAN KUMAR YADAV,Indian National Congress,183427,109,183536,1
Andhra Pradesh,Secundrabad,KHAJA KHALID ANWAR,Bahujan Samaj Party,2856,7,2863,2
Andhra Pradesh,Secundrabad,BANDARU DATTATREYA,Bharatiya Janata Party,437860,411,438271,3
Andhra Pradesh,Secundrabad,T.BHEEMSEN,Telangana Rashtra Samithi,143696,151,143847,4
Andhra Pradesh,Secundrabad,ABDUS SATTAR MUJAHED,ABML(S),807,2,809,5
Andhra Pradesh,Secundrabad,DR.N.S.UDAY KUMAR,pjdl,927,1,928,6
Andhra Pradesh,Secundrabad,KARANKOTE NARENDER,All India Forward Bloc,474,0,474,7
Andhra Pradesh,Secundrabad,KUMAR CHOWDARY YADAV.G,sps,547,0,547,8
Andhra Pradesh,Secundrabad,KHAJA SIRAJUDDIN AZAZ,mmsp,957,2,959,9
Andhra Pradesh,Secundrabad,CHAYA RATAN MUSINIPALLY,Aam Aadmi Party,11162,22,11184,10
Andhra Pradesh,Secundrabad,B.DEEPAK KUMAR,Republican Party of India (Khobragade),1813,0,1813,11
Andhra Pradesh,Secundrabad,NARLA MOHAN RAO,All India Majlis-E-Ittehadul Muslimeen,145095,25,145120,12
Andhra Pradesh,Secundrabad,DR.MALATHI LATHA EPPA,JAP,871,2,873,13
Andhra Pradesh,Secundrabad,CH. MURAHARI,SOCIALIST UNITY CENTRE OF INDIA (COMMUNIST),552,2,554,14
Andhra Pradesh,Secundrabad,MOHD IMTIAZ HUSSAIN,Indian Union Muslim League,784,2,786,15
Andhra Pradesh,Secundrabad,RAGHU DESHABOINA,Bahujan Mukti Party,1494,2,1496,16
Andhra Pradesh,Secundrabad,J.RAMULU,Revolutionary Socialist Party,2057,1,2058,17
Andhra Pradesh,Secundrabad,SHAKTHI SATYAVATHI,Pyramid Party of India,638,0,638,18
Andhra Pradesh,Secundrabad,K. SRINIVASULU,Jai Samaikyandhra Party,3688,3,3691,19
Andhra Pradesh,Secundrabad,SYED SAJID ALI,Yuvajana Sramika Rythu Congress Party,45161,26,45187,20
Andhra Pradesh,Secundrabad,K.SAI KRISHNA MOHAN RAO,ICSP,2599,4,2603,21
Andhra Pradesh,Secundrabad,SONU SARSAL VALMIKI,TECPI,2310,1,2311,22
Andhra Pradesh,Secundrabad,ANANTH RAO GUNDEPALLY,Independent,779,0,779,23
Andhra Pradesh,Secundrabad,AVULA RANGANAYAKULU,Independent,1143,1,1144,24
Andhra Pradesh,Secundrabad,MICHAEL DANIEL OVELZ,Independent,291,0,291,25
Andhra Pradesh,Secundrabad,MOHD ABUBAKAR PARWAIZ SIDDIQUI,Independent,322,0,322,26
Andhra Pradesh,Secundrabad,MOHAMMED RIZWAN HUSSAIN,Independent,370,0,370,27
Andhra Pradesh,Secundrabad,S. LAKSHMAN RAO,Independent,885,1,886,28
Andhra Pradesh,Secundrabad,SYED MADANI QUADRI,Independent,376,0,376,29
Andhra Pradesh,Secundrabad,B.SUBRAMANYAM,Independent,2480,1,2481,30
Andhra Pradesh,Secundrabad,None of the Above,NOTA,6567,5,6572,31
Andhra Pradesh,Hyderabad,S KRISHNA REDDY,Indian National Congress,49301,9,49310,1
Andhra Pradesh,Hyderabad,DR.BHAGAVANTH RAO,Bharatiya Janata Party,311336,78,311414,2
Andhra Pradesh,Hyderabad,RASHID SHAREEF,Telangana Rashtra Samithi,37190,5,37195,3
Andhra Pradesh,Hyderabad,VENU GOPAL.P,Bahujan Samaj Party,3100,0,3100,4
Andhra Pradesh,Hyderabad,ASADUDDIN OWAISI,All India Majlis-E-Ittehadul Muslimeen,513777,91,513868,5
Andhra Pradesh,Hyderabad,S.KHAJA MOINUDDIN,AIACP,1592,1,1593,6
Andhra Pradesh,Hyderabad,JAYA VINDHYALA,Socialist Party (India),598,0,598,7
Andhra Pradesh,Hyderabad,BINGHI RAJASHEKAR,Pyramid Party of India,21796,0,21796,8
Andhra Pradesh,Hyderabad,BODDU SAINATH REDDY,Yuvajana Sramika Rythu Congress Party,10735,8,10743,9
Andhra Pradesh,Hyderabad,N.MAHENDER SINGH,NBNP,485,0,485,10
Andhra Pradesh,Hyderabad,LUBNA SARWATH,Aam Aadmi Party,6118,0,6118,11
Andhra Pradesh,Hyderabad,SYED MUSTAFA MAHMOOD,Majlis Bachao Tahreek,2101,1,2102,12
Andhra Pradesh,Hyderabad,MD OSMAN,Independent,728,0,728,13
Andhra Pradesh,Hyderabad,SHAIK MOIN,Independent,626,0,626,14
Andhra Pradesh,Hyderabad,SYED ABDUL GAFFER,Independent,740,0,740,15
Andhra Pradesh,Hyderabad,M A HABEEB,Independent,5992,0,5992,16
Andhra Pradesh,Hyderabad,None of the Above,NOTA,5011,2,5013,17
Andhra Pradesh,CHELVELLA,KONDA VISHWESHWAR REDDY,Telangana Rashtra Samithi,431084,3993,435077,1
Andhra Pradesh,CHELVELLA,TULLA VEERENDER,Telugu Desam,352227,976,353203,2
Andhra Pradesh,CHELVELLA,PATLOLLA KARTIK REDDY,Indian National Congress,360834,1220,362054,3
Andhra Pradesh,CHELVELLA,SAMALA RAVINDAR,Bahujan Samaj Party,7713,19,7732,4
Andhra Pradesh,CHELVELLA,KUMMARI GIRI,Pyramid Party of India,5787,2,5789,5
Andhra Pradesh,CHELVELLA,KONDA RAGHAVA REDDY,Yuvajana Sramika Rythu Congress Party,40069,66,40135,6
Andhra Pradesh,CHELVELLA,DR.GOLLA RAMAIAH,TLP,1737,28,1765,7
Andhra Pradesh,CHELVELLA,CHAN PASHA,ABML(S),56832,3,56835,8
Andhra Pradesh,CHELVELLA,MD YUNUS MIYA,MCPI,2901,3,2904,9
Andhra Pradesh,CHELVELLA,REGATTE VENKAT REDDY,Aam Aadmi Party,7433,29,7462,10
Andhra Pradesh,CHELVELLA,SYED HASHMATHULLAH QUADRI,Indian Union Muslim League,1399,12,1411,11
Andhra Pradesh,CHELVELLA,DR. P. SADHU SATYANADHAN,ICSP,2487,58,2545,12
Andhra Pradesh,CHELVELLA,SUTHARAPU PADMAIAH,APRSSP,2211,3,2214,13
Andhra Pradesh,CHELVELLA,G.MALLESHAM GOUD,Independent,24650,10,24660,14
Andhra Pradesh,CHELVELLA,SANIKE RAM GOPAL YADAV,Independent,2056,2,2058,15
Andhra Pradesh,CHELVELLA,None of the Above,NOTA,9989,29,10018,16
Andhra Pradesh,Mahbubnagar,KADIRE KRISHNA,Bahujan Samaj Party,15690,89,15779,1
Andhra Pradesh,Mahbubnagar,DR. JANARDHAN REDDY NAGAM,Bharatiya Janata Party,270102,2689,272791,2
Andhra Pradesh,Mahbubnagar,JAIPAL REDDY SUDINI,Indian National Congress,330167,1471,331638,3
Andhra Pradesh,Mahbubnagar,AP JITHENDER REDDY,Telangana Rashtra Samithi,332581,1647,334228,4
Andhra Pradesh,Mahbubnagar,S.R.PREMAIAH,Pyramid Party of India,30379,9,30388,5
Andhra Pradesh,Mahbubnagar,H.A. RAHMAN,Yuvajana Sramika Rythu Congress Party,9065,40,9105,6
Andhra Pradesh,Mahbubnagar,IBRAHIM SYED,Independent,4487,62,4549,7
Andhra Pradesh,Mahbubnagar,DR. CHANDRA SEKHAR. A,Independent,3983,50,4033,8
Andhra Pradesh,Mahbubnagar,S. SHIVA SHANKAR,Independent,3242,10,3252,9
Andhra Pradesh,Mahbubnagar,None of the Above,NOTA,9016,21,9037,10
Andhra Pradesh,Nagarkurnool,YELLAIAH NANDI,Indian National Congress,419040,1035,420075,1
Andhra Pradesh,Nagarkurnool,BAKKANI NARSIMLU,Telugu Desam,182734,618,183352,2
Andhra Pradesh,Nagarkurnool,BAHADHUR SRINIVAS,Bahujan Samaj Party,12022,67,12089,3
Andhra Pradesh,Nagarkurnool,DR. MANDA JAGANNATH,Telangana Rashtra Samithi,401212,2187,403399,4
Andhra Pradesh,Nagarkurnool,MAREDU GOPAL,Yuvajana Sramika Rythu Congress Party,22955,30,22985,5
Andhra Pradesh,Nagarkurnool,BUDDULA SRINIVAS,Independent,54675,5,54680,6
Andhra Pradesh,Nagarkurnool,None of the Above,NOTA,12329,59,12388,7
Andhra Pradesh,Nalgonda,KUNDARAPU RAMESH,Bahujan Samaj Party,11503,14,11517,1
Andhra Pradesh,Nalgonda,GUTHA SUKHENDER REDDY,Indian National Congress,467984,4109,472093,2
Andhra Pradesh,Nalgonda,TERA CHINNAPA REDDY,Telugu Desam,277433,1504,278937,3
Andhra Pradesh,Nalgonda,NANDYALA NARSIMHA REDDY,Communist Party of India  (Marxist),54157,266,54423,4
Andhra Pradesh,Nalgonda,DR. PALLA RAJESHWAR REDDY,Telangana Rashtra Samithi,257953,2724,260677,5
Andhra Pradesh,Nalgonda,GUNNAM NAGI REDDY,Yuvajana Sramika Rythu Congress Party,39339,46,39385,6
Andhra Pradesh,Nalgonda,TEJAVATH BELLAIAH NAIK,Aam Aadmi Party,2297,11,2308,7
Andhra Pradesh,Nalgonda,MANUPURI DAYA SAGAR,Pyramid Party of India,4481,14,4495,8
Andhra Pradesh,Nalgonda,MARRI NEHEMIAH,Independent,56256,3,56259,9
Andhra Pradesh,Nalgonda,None of the Above,NOTA,9284,21,9305,10
Andhra Pradesh,Bhongir ,ARVAPALLY AMBATI,Bahujan Samaj Party,9023,6,9029,1
Andhra Pradesh,Bhongir ,INDRASENA REDDY NALLU,Bharatiya Janata Party,182849,400,183249,2
Andhra Pradesh,Bhongir ,KOMATIREDDY RAJGOPAL REDDY,Indian National Congress,416240,1380,417620,3
Andhra Pradesh,Bhongir ,CHERUPALLY SEETHARAMULU,Communist Party of India  (Marxist),53973,62,54035,4
Andhra Pradesh,Bhongir ,DR. BOORA NARSAIAH GOUD,Telangana Rashtra Samithi,446822,1342,448164,5
Andhra Pradesh,Bhongir ,KAPILAVAI DILEEP KUMAR,Rashtriya Lok Dal,5550,1,5551,6
Andhra Pradesh,Bhongir ,GUDURU JANARDHAN REDDY,Jai Samaikyandhra Party,2342,0,2342,7
Andhra Pradesh,Bhongir ,GUAHATI MOTHILAL,All India Majlis-E-Ittehadul Muslimeen,2598,2,2600,8
Andhra Pradesh,Bhongir ,NAGULA SRINIVAS YADAV,MaSP,1852,6,1858,9
Andhra Pradesh,Bhongir ,BOILLA NARENDER,Republican Party of India (A),6846,1,6847,10
Andhra Pradesh,Bhongir ,NAVULLA MALLA REDDY,Independent,26805,0,26805,11
Andhra Pradesh,Bhongir ,RAVULAPALLY KONDAL RAO,Independent,7720,1,7721,12
Andhra Pradesh,Bhongir ,VARIKUPPALA KRISHNA VADDERA,Independent,35004,0,35004,13
Andhra Pradesh,Bhongir ,None of the Above,NOTA,10869,38,10907,14
Andhra Pradesh,Warangal,KADIYAM SRIHARI,Telangana Rashtra Samithi,658828,2811,661639,1
Andhra Pradesh,Warangal,GANNARAPU SURENDER,Bahujan Samaj Party,9489,47,9536,2
Andhra Pradesh,Warangal,PARAMESHWAR RAMAGALLA,Bharatiya Janata Party,186742,397,187139,3
Andhra Pradesh,Warangal,RAJAIAH SIRICILLA,Indian National Congress,268450,615,269065,4
Andhra Pradesh,Warangal,CHINTHA SWAMY,Aam Aadmi Party,5561,8,5569,5
Andhra Pradesh,Warangal,THUPPARI NARASIMHA SWAMY,Pyramid Party of India,7350,0,7350,6
Andhra Pradesh,Warangal,VENKANNA KANNAM,MCPI,2257,1,2258,7
Andhra Pradesh,Warangal,VENKANNA NEERUDU,Bahujan Mukti Party,2098,0,2098,8
Andhra Pradesh,Warangal,VENU ESAMPELLY,All India Forward Bloc,1541,0,1541,9
Andhra Pradesh,Warangal,KANAKAM RAMESH,Independent,2013,0,2013,10
Andhra Pradesh,Warangal,CHILUVERU PRATHAP,Independent,9178,0,9178,11
Andhra Pradesh,Warangal,JANNU MAHENDAR,Independent,3209,2,3211,12
Andhra Pradesh,Warangal,None of the Above,NOTA,14007,27,14034,13
Andhra Pradesh,Mahabubabad  ,PROF. AZMEERA SEETARAM NAIK,Telangana Rashtra Samithi,319388,1181,320569,1
Andhra Pradesh,Mahabubabad  ,P. BALRAM,Indian National Congress,283735,1842,285577,2
Andhra Pradesh,Mahabubabad  ,BANOTH MOHANLAL,Telugu Desam,215664,240,215904,3
Andhra Pradesh,Mahabubabad  ,BODA RAASI,Bahujan Samaj Party,6220,4,6224,4
Andhra Pradesh,Mahabubabad  ,KAVITHA RANI LUNAVATH,Pyramid Party of India,6633,4,6637,5
Andhra Pradesh,Mahabubabad  ,GUGULOTU JAGAN,MCPI,3662,0,3662,6
Andhra Pradesh,Mahabubabad  ,TELLAM VENKATA RAO,Yuvajana Sramika Rythu Congress Party,127819,653,128472,7
Andhra Pradesh,Mahabubabad  ,EESAM SUDHAKAR,Independent,2193,0,2193,8
Andhra Pradesh,Mahabubabad  ,V. GOURI NAGAMANI,Independent,13580,83,13663,9
Andhra Pradesh,Mahabubabad  ,DATLA NAGESHWAR RAO,Independent,6833,20,6853,10
Andhra Pradesh,Mahabubabad  ,PADIGA YARRAIAH,Independent,3496,2,3498,11
Andhra Pradesh,Mahabubabad  ,PAYAM CHANDHAR RAO (CHINNA CHANDHRANNA),Independent,94029,15,94044,12
Andhra Pradesh,Mahabubabad  ,PONAKA SAMMAKKA,Independent,3443,0,3443,13
Andhra Pradesh,Mahabubabad  ,BALUNAYAK BHUKYA,Independent,3091,0,3091,14
Andhra Pradesh,Mahabubabad  ,METLA PAPAIAH,Independent,3882,43,3925,15
Andhra Pradesh,Mahabubabad  ,LAXMAN BUKYA,Independent,14029,5,14034,16
Andhra Pradesh,Mahabubabad  ,LAXMINARAYANA BORRA,Independent,5879,0,5879,17
Andhra Pradesh,Mahabubabad  ,None of the Above,NOTA,6695,9,6704,18
Andhra Pradesh,Khammam ,KANKANALA NARAYANA,Communist Party of India,187266,436,187702,1
Andhra Pradesh,Khammam ,DODDA RAM BABU,Bahujan Samaj Party,4758,3,4761,2
Andhra Pradesh,Khammam ,NAMA NAGESWARA RAO,Telugu Desam,407614,2616,410230,3
Andhra Pradesh,Khammam ,BUDAN BAIG SHAIK,Telangana Rashtra Samithi,88944,180,89124,4
Andhra Pradesh,Khammam ,NAGARJUNA CHERUKURU,Jai Samaikyandhra Party,4994,8,5002,5
Andhra Pradesh,Khammam ,PONGULETI  SRINIVASA REDDY,Yuvajana Sramika Rythu Congress Party,418609,3825,422434,6
Andhra Pradesh,Khammam ,MEDARAMETLA  RAMA RAO,Pyramid Party of India,4136,3,4139,7
Andhra Pradesh,Khammam ,KANAKAM TIRUMALA RAO,Independent,917,0,917,8
Andhra Pradesh,Khammam ,KALTHI RAMULAMMA,Independent,983,0,983,9
Andhra Pradesh,Khammam ,KALTHI VENKATESWARLU,Independent,1063,0,1063,10
Andhra Pradesh,Khammam ,KAKI BHASKAR,Independent,5368,0,5368,11
Andhra Pradesh,Khammam ,GUGULOTHU RANJITH KUMAR,Independent,1434,0,1434,12
Andhra Pradesh,Khammam ,GUGULOTHU SARVAN,Independent,1491,0,1491,13
Andhra Pradesh,Khammam ,GOKINEPALLI VENKATESWARA RAO (GVR),Independent,8041,14,8055,14
Andhra Pradesh,Khammam ,JERRIPOTHULA SRINIVAS,Independent,1116,0,1116,15
Andhra Pradesh,Khammam ,NAGIREDDY RAJI REDDY (RAJANNA),Independent,4484,0,4484,16
Andhra Pradesh,Khammam ,BACHALA LAXMAIAH,Independent,6506,0,6506,17
Andhra Pradesh,Khammam ,BANOTH KISHAN NAYAK,Independent,1617,0,1617,18
Andhra Pradesh,Khammam ,BANOTH LAXMA NAIK,Independent,1342,0,1342,19
Andhra Pradesh,Khammam ,BUSIREDDY SHANKAR REDDY,Independent,964,0,964,20
Andhra Pradesh,Khammam ,MARIKANTI VASUDASU,Independent,879,0,879,21
Andhra Pradesh,Khammam ,MUDIGE NAGESWARA RAO,Independent,1202,0,1202,22
Andhra Pradesh,Khammam ,MOKALLA RAMESH,Independent,5401,0,5401,23
Andhra Pradesh,Khammam ,RAMESH KOMMU,Independent,1273,1,1274,24
Andhra Pradesh,Khammam ,RAMU KANDULA,Independent,1021,0,1021,25
Andhra Pradesh,Khammam ,LINGALA RAVI KUMAR,Independent,9459,1,9460,26
Andhra Pradesh,Khammam ,SANAPA POMMAIAH,Independent,889,0,889,27
Andhra Pradesh,Khammam ,None of the Above,NOTA,4978,13,4991,28
Andhra Pradesh,Aruku ,KISHORE CHANDRA DEO,Indian National Congress,52574,310,52884,1
Andhra Pradesh,Aruku ,GUMMIDI SANDHYARANI,Telugu Desam,319846,1947,321793,2
Andhra Pradesh,Aruku ,MIDIYAM BABURAO,Communist Party of India  (Marxist),38254,644,38898,3
Andhra Pradesh,Aruku ,KOTHAPALLI GEETHA,Yuvajana Sramika Rythu Congress Party,410730,2461,413191,4
Andhra Pradesh,Aruku ,BURJABARIKI DHANARAJU,Aam Aadmi Party,8539,30,8569,5
Andhra Pradesh,Aruku ,IILLA RAMI REDDY,Independent,5685,7,5692,6
Andhra Pradesh,Aruku ,KANGALA BALUDORA,Independent,23197,18,23215,7
Andhra Pradesh,Aruku ,CHETTI SANKARARAO,Independent,8934,17,8951,8
Andhra Pradesh,Aruku ,BIDDIKA RAMAIAH,Independent,7581,6,7587,9
Andhra Pradesh,Aruku ,VANUGU SANKARARAO,Independent,4591,23,4614,10
Andhra Pradesh,Aruku ,SALLANGI RATNAM,Independent,7648,40,7688,11
Andhra Pradesh,Aruku ,None of the Above,NOTA,16496,36,16532,12
Andhra Pradesh,Srikakulam,KILLI KRUPARANI,Indian National Congress,24038,133,24171,1
Andhra Pradesh,Srikakulam,BODDEPALLI RAJARAO,Bahujan Samaj Party,8036,13,8049,2
Andhra Pradesh,Srikakulam,RAMMOHAN NAIDU KINJARAPU,Telugu Desam,552348,4197,556545,3
Andhra Pradesh,Srikakulam,KADIYAM JAYALAKSHMI,Pyramid Party of India,5023,3,5026,4
Andhra Pradesh,Srikakulam,JAIDEV INJARAPU,Aam Aadmi Party,2517,42,2559,5
Andhra Pradesh,Srikakulam,PAIDI RAJA RAO,Jai Samaikyandhra Party,11334,89,11423,6
Andhra Pradesh,Srikakulam,REDDY SHANTHI,Yuvajana Sramika Rythu Congress Party,426135,2718,428853,7
Andhra Pradesh,Srikakulam,VASUDEVA RAO BODDU,Communist Party of India (Marxist-Lenninist) (Liberation),5128,4,5132,8
Andhra Pradesh,Srikakulam,KINJARAPU TEJESWARA RAO,Independent,2074,1,2075,9
Andhra Pradesh,Srikakulam,TOTA TEJESWARA RAO,Independent,2143,1,2144,10
Andhra Pradesh,Srikakulam,None of the Above,NOTA,6100,38,6138,11
Andhra Pradesh,Vizianagaram,ASHOK GAJAPATHI RAJU PUSAPATI,Telugu Desam,534357,2192,536549,1
Andhra Pradesh,Vizianagaram,JHANSI LAKSHMI BOTCHA,Indian National Congress,122091,396,122487,2
Andhra Pradesh,Vizianagaram,BONU KRISHNA,Bahujan Samaj Party,4091,1,4092,3
Andhra Pradesh,Vizianagaram,TADIVAKA RAMESH NAIDU,Jai Samaikyandhra Party,3346,42,3388,4
Andhra Pradesh,Vizianagaram,NARU SIMHADRI NAIDU,Aam Aadmi Party,2476,29,2505,5
Andhra Pradesh,Vizianagaram,PRASADA RAO NANDA,Pyramid Party of India,6396,5,6401,6
Andhra Pradesh,Vizianagaram,VENKATA SWETHA CHALAPATHI KUMARA KRISHNA RANGARAO RAVU,Yuvajana Sramika Rythu Congress Party,427629,2009,429638,7
Andhra Pradesh,Vizianagaram,YELLA RAO SIYYADULA,Independent,5125,0,5125,8
Andhra Pradesh,Vizianagaram,HARIKISHAN KUPPILI,Independent,3573,30,3603,9
Andhra Pradesh,Vizianagaram,None of the Above,NOTA,6506,22,6528,10
Andhra Pradesh,Visakhapatnam,IMANDI VENKATA KURMARAO,Bahujan Samaj Party,14941,6,14947,1
Andhra Pradesh,Visakhapatnam,KAMBHAMPATI HARI BABU,Bharatiya Janata Party,565326,1506,566832,2
Andhra Pradesh,Visakhapatnam,BOLISETTI SATYANARAYANA (SATYA),Indian National Congress,50605,27,50632,3
Andhra Pradesh,Visakhapatnam,KUNA RAMAM,Aam Aadmi Party,6147,28,6175,4
Andhra Pradesh,Visakhapatnam,DADI JYOTHI BHAVANI,Pyramid Party of India,2715,2,2717,5
Andhra Pradesh,Visakhapatnam,DR|| BHAVANI SANKAR SASTRY.A,ICSP,1907,3,1910,6
Andhra Pradesh,Visakhapatnam,JT RAMARAO,sps,4316,7,4323,7
Andhra Pradesh,Visakhapatnam,Y.S VIJAYAMMA,Yuvajana Sramika Rythu Congress Party,474628,1716,476344,8
Andhra Pradesh,Visakhapatnam,SABBAM HARI,Jai Samaikyandhra Party,6598,46,6644,9
Andhra Pradesh,Visakhapatnam,UMAMAHESWARARAO ARETI,Independent,1750,1,1751,10
Andhra Pradesh,Visakhapatnam,KUTIKUPPALA SURYA RAO,Independent,1879,10,1889,11
Andhra Pradesh,Visakhapatnam,KURADA SATYANARAYANA PATNAIK,Independent,1925,2,1927,12
Andhra Pradesh,Visakhapatnam,GEDELA KRISHNARAO,Independent,1117,1,1118,13
Andhra Pradesh,Visakhapatnam,CHANDRASEKHAR BUDDA,Independent,1347,1,1348,14
Andhra Pradesh,Visakhapatnam,CHALAPATHIRAO RONANKI,Independent,1593,1,1594,15
Andhra Pradesh,Visakhapatnam,TANUKU DIVAKAR,Independent,5418,0,5418,16
Andhra Pradesh,Visakhapatnam,DURGAPRASAD GUNTU,Independent,2610,1,2611,17
Andhra Pradesh,Visakhapatnam,NAGENDRA SAIRAM,Independent,2377,0,2377,18
Andhra Pradesh,Visakhapatnam,J. PADMAJA,Independent,1539,1,1540,19
Andhra Pradesh,Visakhapatnam,BRAHMA SWAROOP KASIBHATTA,Independent,991,3,994,20
Andhra Pradesh,Visakhapatnam,SREENADH REDDY,Independent,1378,1,1379,21
Andhra Pradesh,Visakhapatnam,SEEMAKURTHI SRINUVASU (BHAGHAVAN SRINU),Independent,1759,0,1759,22
Andhra Pradesh,Visakhapatnam,None of the Above,NOTA,7312,17,7329,23
Andhra Pradesh,Anakapalli,KARANAM TIRUPATHI RAO,Bahujan Samaj Party,14819,15,14834,1
Andhra Pradesh,Anakapalli,MUTTAMSETTI SRINIVASA RAO (AVANTHI),Telugu Desam,566667,1796,568463,2
Andhra Pradesh,Anakapalli,VIJAYA LAKSHMI THOTA,Indian National Congress,17697,73,17770,3
Andhra Pradesh,Anakapalli,KONDARAJU JAMPANA,Jai Samaikyandhra Party,6215,46,6261,4
Andhra Pradesh,Anakapalli,GUDIVADA AMARNADH,Yuvajana Sramika Rythu Congress Party,518566,1965,520531,5
Andhra Pradesh,Anakapalli,VADLAMURI KRISHNA SWAROOP,DABAP,5501,5,5506,6
Andhra Pradesh,Anakapalli,SARISA LEELA PRASANNA KUMARI,Pyramid Party of India,2871,4,2875,7
Andhra Pradesh,Anakapalli,APPALARAJU SADARAM,Independent,3225,3,3228,8
Andhra Pradesh,Anakapalli,None of the Above,NOTA,8559,45,8604,9
Andhra Pradesh,Kakinada,THOTA NARASIMHAM,Telugu Desam,512045,2357,514402,1
Andhra Pradesh,Kakinada,MALLIPUDI MANGAPATI PALLAM RAJU,Indian National Congress,19528,226,19754,2
Andhra Pradesh,Kakinada,MUTHABATHULA RATNA KUMAR,Bahujan Samaj Party,2469,42,2511,3
Andhra Pradesh,Kakinada,ARJUNARAO YEGUPATI,Communist Party of India (Marxist-Lenninist) (Liberation),1489,6,1495,4
Andhra Pradesh,Kakinada,KOLA VENKATA PRASAD VARMA,Rashtriya Janata Dal,3459,14,3473,5
Andhra Pradesh,Kakinada,CHALAMALASETTY SUNIL,Yuvajana Sramika Rythu Congress Party,508068,2903,510971,6
Andhra Pradesh,Kakinada,TEKUMUDI VENKATA RAO,Pyramid Party of India,3819,7,3826,7
Andhra Pradesh,Kakinada,TUMMALAPALLI SATYA RAMAKRISHNA,Jai Samaikyandhra Party,6263,179,6442,8
Andhra Pradesh,Kakinada,MOTHA SARADA,Republican Party of India (Khobragade),6835,1,6836,9
Andhra Pradesh,Kakinada,ROKKAM DAYAKAR,Republican Paksha (Khoripa),1834,3,1837,10
Andhra Pradesh,Kakinada,SRINIVAS DANGETI,Aam Aadmi Party,2266,90,2356,11
Andhra Pradesh,Kakinada,KARRA VENKATA APPALA NARASIMHA RAO,Independent,1904,3,1907,12
Andhra Pradesh,Kakinada,KUNCHE RAMADAS,Independent,1117,5,1122,13
Andhra Pradesh,Kakinada,GUTTULA ANNAPURNA SESHAGIRI RAO (BATHPARTY-SESHU),Independent,1413,4,1417,14
Andhra Pradesh,Kakinada,CHAGANTI SURYANARAYANA MURTY,Independent,1230,6,1236,15
Andhra Pradesh,Kakinada,JALLURI VENKATESWARLU (J.V),Independent,6634,2,6636,16
Andhra Pradesh,Kakinada,DONKA LEELAVATHI,Independent,3754,2,3756,17
Andhra Pradesh,Kakinada,DONAM NEELAKANTAM,Independent,1693,4,1697,18
Andhra Pradesh,Kakinada,PEPAKAYALA SUBHA RAJENDRA,Independent,1158,3,1161,19
Andhra Pradesh,Kakinada,PRABHAKARA RAO MADIKI,Independent,495,1,496,20
Andhra Pradesh,Kakinada,MERLA BHAVANI SANKARA PRASAD,Independent,908,2,910,21
Andhra Pradesh,Kakinada,VINJAMALLA CHITTI BABU,Independent,1394,6,1400,22
Andhra Pradesh,Kakinada,None of the Above,NOTA,4158,200,4358,23
Andhra Pradesh,Amalapuram ,AITHABATHULA JOGESWARA VENKATA BUTCHI MAHESWARA RAO,Indian National Congress,12092,90,12182,1
Andhra Pradesh,Amalapuram ,GEDDAM SAMPADA RAO,Bahujan Samaj Party,7117,102,7219,2
Andhra Pradesh,Amalapuram ,DR PANDULA RAVINDRA BABU,Telugu Desam,591480,3067,594547,3
Andhra Pradesh,Amalapuram ,KUNCHE PEDASATYANARAYANA,Pyramid Party of India,4543,17,4560,4
Andhra Pradesh,Amalapuram ,KONKI VENKATA RAO,Republican Paksha (Khoripa),3220,13,3233,5
Andhra Pradesh,Amalapuram ,PINIPE VISWARUPU,Yuvajana Sramika Rythu Congress Party,470804,3167,473971,6
Andhra Pradesh,Amalapuram ,VIJAYA CHAKRAVARTHY PANTHAGADA,Republican Party of India (Khobragade),2861,6,2867,7
Andhra Pradesh,Amalapuram ,G.V.HARSHA KUMAR,Jai Samaikyandhra Party,9587,344,9931,8
Andhra Pradesh,Amalapuram ,UNDRU GANI RAJU,Independent,856,6,862,9
Andhra Pradesh,Amalapuram ,KASI CHANDRAMOULI,Independent,1090,20,1110,10
Andhra Pradesh,Amalapuram ,KOMMU SATYAVATHI,Independent,619,6,625,11
Andhra Pradesh,Amalapuram ,BHASKARA RAO BUNGA,Independent,816,8,824,12
Andhra Pradesh,Amalapuram ,YALANGI RAMESH,Independent,1161,10,1171,13
Andhra Pradesh,Amalapuram ,VADDI WINSTON CHURCHILL,Independent,1676,8,1684,14
Andhra Pradesh,Amalapuram ,None of the Above,NOTA,5992,149,6141,15
Andhra Pradesh,Rajahmundry,DURGESH KANDULA,Indian National Congress,21056,187,21243,1
Andhra Pradesh,Rajahmundry,MARRE BABJI,Bahujan Samaj Party,6037,42,6079,2
Andhra Pradesh,Rajahmundry,MURALI MOHAN MAGANTI,Telugu Desam,627653,2920,630573,3
Andhra Pradesh,Rajahmundry,KOLLABATHULA RICHMOND CAREY,GaAP,5457,24,5481,4
Andhra Pradesh,Rajahmundry,BODDU VENKATARAMANA CHOWDARY,Yuvajana Sramika Rythu Congress Party,461204,1935,463139,5
Andhra Pradesh,Rajahmundry,MULLAPUDI SATYANARAYANA,Jai Samaikyandhra Party,11540,178,11718,6
Andhra Pradesh,Rajahmundry,MEDA SRINIVAS,Rashtriya Praja Congress (Secular),985,6,991,7
Andhra Pradesh,Rajahmundry,SANGISETTI SRINIVASA RAO,Pyramid Party of India,1322,7,1329,8
Andhra Pradesh,Rajahmundry,ANNAMDEVULA DHARMA RAO,Independent,588,2,590,9
Andhra Pradesh,Rajahmundry,CHEEKATLA VENKATESWARA RAO,Independent,1351,5,1356,10
Andhra Pradesh,Rajahmundry,PALLA VENKATA NAIDU(PRADEEP),Independent,978,11,989,11
Andhra Pradesh,Rajahmundry,POLU PEDA VENGALA REDDY,Independent,764,1,765,12
Andhra Pradesh,Rajahmundry,MUTYALA RAMBABU,Independent,1277,5,1282,13
Andhra Pradesh,Rajahmundry,ILLA GOVINDA RAJAN,Independent,1390,0,1390,14
Andhra Pradesh,Rajahmundry,None of the Above,NOTA,7361,95,7456,15
Andhra Pradesh,Narsapuram,KANUMURU BAPI RAJU,Indian National Congress,26859,224,27083,1
Andhra Pradesh,Narsapuram,GOKARAJU GANGA RAJU,Bharatiya Janata Party,537498,2808,540306,2
Andhra Pradesh,Narsapuram,CHINTAPALLI KANAKA RAO,Bahujan Samaj Party,8454,37,8491,3
Andhra Pradesh,Narsapuram,S.V.P.K.H.G.KRISHNAM RAJU,Pyramid Party of India,4205,27,4232,4
Andhra Pradesh,Narsapuram,GITADAS DAS,pjdl,23255,5,23260,5
Andhra Pradesh,Narsapuram,NALLI RAJESH,Republican Paksha (Khoripa),6705,3,6708,6
Andhra Pradesh,Narsapuram,VANKA RAVINDRANATH,Yuvajana Sramika Rythu Congress Party,452576,2379,454955,7
Andhra Pradesh,Narsapuram,SAROJA  POLASAPALLI,Jai Samaikyandhra Party,6704,134,6838,8
Andhra Pradesh,Narsapuram,ADDANKI (SEKHAR BABU) DORABABU,Independent,1339,11,1350,9
Andhra Pradesh,Narsapuram,BADAMPUDI SIVA,Independent,1597,8,1605,10
Andhra Pradesh,Narsapuram,MEDAPATI  VARAHALA REDDY,Independent,1242,8,1250,11
Andhra Pradesh,Narsapuram,VANGALAPUDI YASHYAA,Independent,1274,7,1281,12
Andhra Pradesh,Narsapuram,VOLETI VENKATA LAKSHMANA RAO,Independent,1295,3,1298,13
Andhra Pradesh,Narsapuram,SHIVAJI GOTTUMUKKALA,Independent,2274,12,2286,14
Andhra Pradesh,Narsapuram,None of the Above,NOTA,7900,104,8004,15
Andhra Pradesh,Eluru ,NETALA RAMESH BABU,Bahujan Samaj Party,11624,46,11670,1
Andhra Pradesh,Eluru ,MAGANTI VENKATESWARA RAO (BABU),Telugu Desam,620374,3097,623471,2
Andhra Pradesh,Eluru ,MUSUNURI NAGESWARA RAO,Indian National Congress,11680,90,11770,3
Andhra Pradesh,Eluru ,ASHOK YANTRAPATI,MaSP,1205,7,1212,4
Andhra Pradesh,Eluru ,GOVADA VIJAYA KUMARI,pjdl,4477,6,4483,5
Andhra Pradesh,Eluru ,THOTA CHANDRA SEKHAR,Yuvajana Sramika Rythu Congress Party,518063,3482,521545,6
Andhra Pradesh,Eluru ,MENDEM SANTOSH KUMAR ( PEDABABULU),ILP(AP),3409,14,3423,7
Andhra Pradesh,Eluru ,U .V. RAMA RAO,Pyramid Party of India,1311,12,1323,8
Andhra Pradesh,Eluru ,SAVANAPUDI NAGARAJU,MCPI,2310,8,2318,9
Andhra Pradesh,Eluru ,K.V.V.SATYANARAYANA,Jai Samaikyandhra Party,2761,112,2873,10
Andhra Pradesh,Eluru ,GANGADHARA RAO NANNAPANENI,Independent,1293,9,1302,11
Andhra Pradesh,Eluru ,JULURI BHASKARA VEERA VENKATA ANIL KUMAR GUPTA,Independent,750,1,751,12
Andhra Pradesh,Eluru ,K.VIJAYA LAKSHMI PANDIT,Independent,1312,8,1320,13
Andhra Pradesh,Eluru ,U VENKATESWARARAO (U.V),Independent,3957,14,3971,14
Andhra Pradesh,Eluru ,C.V.SARADA DEVI,Independent,2715,6,2721,15
Andhra Pradesh,Eluru ,None of the Above,NOTA,7479,65,7544,16
Andhra Pradesh,Machilipatnam ,KONAKALLA NARAYANA RAO,Telugu Desam,583374,3906,587280,1
Andhra Pradesh,Machilipatnam ,PRASADA RAO PEGGEM,Bahujan Samaj Party,4057,28,4085,2
Andhra Pradesh,Machilipatnam ,SISTLA RAMESH,Indian National Congress,13992,119,14111,3
Andhra Pradesh,Machilipatnam ,KAMMILI SRINIVAS,Jai Samaikyandhra Party,7508,184,7692,4
Andhra Pradesh,Machilipatnam ,KOLUSU PARTHA SARATHY,Yuvajana Sramika Rythu Congress Party,502875,3348,506223,5
Andhra Pradesh,Machilipatnam ,VADAPALLI RAGHUNADH,Pyramid Party of India,4393,8,4401,6
Andhra Pradesh,Machilipatnam ,JAMPANA SRINIVASA GOUD,Independent,921,10,931,7
Andhra Pradesh,Machilipatnam ,PARASA SRINIVASA RAO,Independent,3395,4,3399,8
Andhra Pradesh,Machilipatnam ,MOHAMMAD ISHAQ,Independent,1758,12,1770,9
Andhra Pradesh,Machilipatnam ,YUNDURI SUBRAMANYASWARA RAO (MANI),Independent,1596,1,1597,10
Andhra Pradesh,Machilipatnam ,YARLAGADDA RAMA MOHAN RAO,Independent,1398,7,1405,11
Andhra Pradesh,Machilipatnam ,None of the Above,NOTA,8003,168,8171,12
Andhra Pradesh,Vijayawada,AVINASH DEVINENI,Indian National Congress,39524,236,39760,1
Andhra Pradesh,Vijayawada,KESINENI SRINIVAS (NANI),Telugu Desam,589702,3251,592953,2
Andhra Pradesh,Vijayawada,CHIGURUPATI RAMALINGESWARA RAO,Bahujan Samaj Party,3549,33,3582,3
Andhra Pradesh,Vijayawada,ISHWARYA LAKSHMI CHINNAM,Jai Samaikyandhra Party,5175,121,5296,4
Andhra Pradesh,Vijayawada,KAMBALA. SUBRAHMANYAM (SASTRY),Welfare Party of India,7529,10,7539,5
Andhra Pradesh,Vijayawada,KONERU RAJENDRA PRASAD,Yuvajana Sramika Rythu Congress Party,514926,3313,518239,6
Andhra Pradesh,Vijayawada,RAJA KUMARI GUNDAPANENI,Pyramid Party of India,2564,7,2571,7
Andhra Pradesh,Vijayawada,SUNKARA KRISHNA MURTHY,ARPS,799,4,803,8
Andhra Pradesh,Vijayawada,HAR MOHINDER SINGH SAHANI,Aam Aadmi Party,3021,67,3088,9
Andhra Pradesh,Vijayawada,ALTAF ALI MOHAMED,Independent,1164,4,1168,10
Andhra Pradesh,Vijayawada,AHMED ANSARI SYED,Independent,499,5,504,11
Andhra Pradesh,Vijayawada,P.V. KRISHNAIAH,Independent,420,3,423,12
Andhra Pradesh,Vijayawada,KONERU RAJENDRA PRASAD,Independent,861,153,1014,13
Andhra Pradesh,Vijayawada,KONERU RAMACHANDRA PRASAD,Independent,1077,22,1099,14
Andhra Pradesh,Vijayawada,CHATRAGADDA PRATAP,Independent,948,2,950,15
Andhra Pradesh,Vijayawada,TATINENI SRINIVASA RAO,Independent,2454,6,2460,16
Andhra Pradesh,Vijayawada,DASARI VENKATA NAGESH,Independent,1871,3,1874,17
Andhra Pradesh,Vijayawada,M.PHANI PRAKASH,Independent,2808,1,2809,18
Andhra Pradesh,Vijayawada,BOLISETTY HARIBABU,Independent,662,5,667,19
Andhra Pradesh,Vijayawada,V.R.K.MURTHY.,Independent,745,4,749,20
Andhra Pradesh,Vijayawada,YARAM KATAM RAJU,Independent,1401,1,1402,21
Andhra Pradesh,Vijayawada,SURAPANENI SARATBABU,Independent,1515,6,1521,22
Andhra Pradesh,Vijayawada,None of the Above,NOTA,5165,129,5294,23
Andhra Pradesh,Guntur,ABDUL WAHEED SHAIK,Indian National Congress,46677,141,46818,1
Andhra Pradesh,Guntur,JAYADEV GALLA,Telugu Desam,615170,3247,618417,2
Andhra Pradesh,Guntur,MALLELA BABU RAO,Bahujan Samaj Party,4201,22,4223,3
Andhra Pradesh,Guntur,ABBURI KOTESWARA RAO,Pyramid Party of India,1635,1,1636,4
Andhra Pradesh,Guntur,EMANI CHANDRA SEKHAR RAO,NPT,1454,1,1455,5
Andhra Pradesh,Guntur,UDAIA KUMAR MUSUKU,ICSP,2814,38,2852,6
Andhra Pradesh,Guntur,KATA VEERA VARA PRASAD,Aam Aadmi Party,2289,55,2344,7
Andhra Pradesh,Guntur,DR. KOUTHARAPU RAVINDRA,GRIP,2586,8,2594,8
Andhra Pradesh,Guntur,BALASHOWRY VALLABHANENI,Yuvajana Sramika Rythu Congress Party,545602,3704,549306,9
Andhra Pradesh,Guntur,MALLELA VENKATA RAO,Jai Samaikyandhra Party,5554,54,5608,10
Andhra Pradesh,Guntur,ARUDALA VENKATESWARA RAO,Independent,901,7,908,11
Andhra Pradesh,Guntur,BITRA VENKATA SIVANNARAYANA,Independent,1166,3,1169,12
Andhra Pradesh,Guntur,None of the Above,NOTA,7530,66,7596,13
Andhra Pradesh,Narasaraopet,KONDAPALLI VENKATESWARLU,Indian National Congress,22870,73,22943,1
Andhra Pradesh,Narasaraopet,MEKALA HANUMANTHA RAO YADAV,Bahujan Samaj Party,4896,15,4911,2
Andhra Pradesh,Narasaraopet,SAMBASIVA RAO RAYAPATI,Telugu Desam,629706,2758,632464,3
Andhra Pradesh,Narasaraopet,AKKI REDDY BHIMANADULA,Pyramid Party of India,7026,6,7032,4
Andhra Pradesh,Narasaraopet,AYODHYA RAMIREDDY ALLA,Yuvajana Sramika Rythu Congress Party,594230,2954,597184,5
Andhra Pradesh,Narasaraopet,YELURI SRILATHA,Jai Samaikyandhra Party,5108,34,5142,6
Andhra Pradesh,Narasaraopet,ROSAIAH SIVAPARAPU,MCPI,1869,8,1877,7
Andhra Pradesh,Narasaraopet,KANUMURI KOTESWARA RAO,Independent,1401,3,1404,8
Andhra Pradesh,Narasaraopet,JANGALA SINGARAIAH YADAV,Independent,967,6,973,9
Andhra Pradesh,Narasaraopet,PARUVURI RAMESH,Independent,1118,0,1118,10
Andhra Pradesh,Narasaraopet,RAVU SUBRAHMANYAM,Independent,1023,2,1025,11
Andhra Pradesh,Narasaraopet,None of the Above,NOTA,5943,42,5985,12
Andhra Pradesh,Bapatla ,DWARAPALLI PHILIP,Bahujan Samaj Party,8093,20,8113,1
Andhra Pradesh,Bapatla ,PANABAKA LAKSHMI,Indian National Congress,22963,109,23072,2
Andhra Pradesh,Bapatla ,MALYADRI SRIRAM,Telugu Desam,574690,3455,578145,3
Andhra Pradesh,Bapatla ,EDA CHENNAIAH,Aam Aadmi Party,3924,24,3948,4
Andhra Pradesh,Bapatla ,PERLI PRASANNA DEEVENA KUMAR (PRASANNA),ILP(AP),2959,8,2967,5
Andhra Pradesh,Bapatla ,YALLAMATI RAMESH,Pyramid Party of India,8406,8,8414,6
Andhra Pradesh,Bapatla ,VARIKUTI AMRUTHAPANI,Yuvajana Sramika Rythu Congress Party,542461,2930,545391,7
Andhra Pradesh,Bapatla ,R.D.WILSON,Jai Samaikyandhra Party,3617,40,3657,8
Andhra Pradesh,Bapatla ,GADDE THYAGARAJU,Independent,747,2,749,9
Andhra Pradesh,Bapatla ,GOGULAMUDI NARASIMHA RAO,Independent,718,2,720,10
Andhra Pradesh,Bapatla ,NAKKALA VEERANJANEYULU,Independent,613,2,615,11
Andhra Pradesh,Bapatla ,BANDELA NAGESWARA RAO,Independent,666,2,668,12
Andhra Pradesh,Bapatla ,BABURAO GOLLA,Independent,823,0,823,13
Andhra Pradesh,Bapatla ,RATNABABU MAMIDI,Independent,1200,6,1206,14
Andhra Pradesh,Bapatla ,None of the Above,NOTA,6052,94,6146,15
Andhra Pradesh,Ongole ,KRISHNA RAO VEMULA,Bahujan Samaj Party,5852,12,5864,1
Andhra Pradesh,Ongole ,DARISI PAVAN KUMAR,Indian National Congress,13321,35,13356,2
Andhra Pradesh,Ongole ,MAGUNTA SREENIVASULU REDDY,Telugu Desam,569401,4901,574302,3
Andhra Pradesh,Ongole ,GOLLAPALLI KISHORE KUMAR REDDY,Jai Samaikyandhra Party,3705,19,3724,4
Andhra Pradesh,Ongole ,PAMMI VENKA REDDY,Pyramid Party of India,1382,10,1392,5
Andhra Pradesh,Ongole ,S.S.N.RAJA YADAV,Aam Aadmi Party,4364,29,4393,6
Andhra Pradesh,Ongole ,Y.V.SUBBA REDDY,Yuvajana Sramika Rythu Congress Party,584516,5345,589861,7
Andhra Pradesh,Ongole ,KAVURI VENUBABU NAIDU,Independent,3206,1,3207,8
Andhra Pradesh,Ongole ,KIRAN DASARANNA MATTEGUNTA,Independent,755,1,756,9
Andhra Pradesh,Ongole ,CHAPALA VENKATA RAO,Independent,879,0,879,10
Andhra Pradesh,Ongole ,DAMA MOHAN RAO,Independent,492,0,492,11
Andhra Pradesh,Ongole ,PIDAPARTHI MADHUSUDHANA REDDY,Independent,625,0,625,12
Andhra Pradesh,Ongole ,B. BALAJEE RAO,Independent,658,0,658,13
Andhra Pradesh,Ongole ,BELLAMKONDA VENKATRAO,Independent,999,0,999,14
Andhra Pradesh,Ongole ,RADHAKRISHNA SOMISETTY,Independent,1936,0,1936,15
Andhra Pradesh,Ongole ,None of the Above,NOTA,5764,17,5781,16
Andhra Pradesh,Nandyal,OBULESU THUDUM,Bahujan Samaj Party,11782,2,11784,1
Andhra Pradesh,Nandyal,N.MD.FAROOK,Telugu Desam,514780,1865,516645,2
Andhra Pradesh,Nandyal,B.Y.RAMAIAH,Indian National Congress,16341,37,16378,3
Andhra Pradesh,Nandyal,ULLAGI DAVID JAYA KUMAR,Aam Aadmi Party,2475,24,2499,4
Andhra Pradesh,Nandyal,NOSSAM MALLIKARJUNA REDDY,Jai Samaikyandhra Party,7169,20,7189,5
Andhra Pradesh,Nandyal,S.P.Y REDDY,Yuvajana Sramika Rythu Congress Party,620061,2350,622411,6
Andhra Pradesh,Nandyal,P.V.N. REDDY,All India Majlis-E-Ittehadul Muslimeen,5586,12,5598,7
Andhra Pradesh,Nandyal,K.P.KAMBAGIRI SWAMI,Independent,2708,0,2708,8
Andhra Pradesh,Nandyal,GADDALA BALASWAMY,Independent,1495,0,1495,9
Andhra Pradesh,Nandyal,P.NARENDRA DEV,Independent,932,4,936,10
Andhra Pradesh,Nandyal,I.V PAKKIRA REDDY,Independent,1031,5,1036,11
Andhra Pradesh,Nandyal,PIDISELA VIJAY KUMAR,Independent,1325,0,1325,12
Andhra Pradesh,Nandyal,M RAMANA REDDY,Independent,5400,0,5400,13
Andhra Pradesh,Nandyal,VANGALA SREENIVASA REDDY,Independent,2433,4,2437,14
Andhra Pradesh,Nandyal,None of the Above,NOTA,7089,26,7115,15
Andhra Pradesh,Kurnool,KOTLA JAYASURYAPRAKASH REDDY,Indian National Congress,116266,337,116603,1
Andhra Pradesh,Kurnool,B.T. NAIDU,Telugu Desam,427292,1359,428651,2
Andhra Pradesh,Kurnool,R.J.MALLIKAL,Bahujan Samaj Party,5739,7,5746,3
Andhra Pradesh,Kurnool,KONDIPARTHI .VENKAT  PRASAD,Republican Party of India,1614,0,1614,4
Andhra Pradesh,Kurnool,G.JAKEER HUSSAIN,Jai Samaikyandhra Party,3585,15,3600,5
Andhra Pradesh,Kurnool,NAGELLA ELIA,Welfare Party of India,1986,4,1990,6
Andhra Pradesh,Kurnool,NOOR AHMED MADANI,SDP,11381,12,11393,7
Andhra Pradesh,Kurnool,BUTTA RENUKA,Yuvajana Sramika Rythu Congress Party,471525,1257,472782,8
Andhra Pradesh,Kurnool,VISSA KIRAN KUMAR,Aam Aadmi Party,6478,44,6522,9
Andhra Pradesh,Kurnool,KOTHURU.SATYANARAYANA GUPTA,Independent,2020,1,2021,10
Andhra Pradesh,Kurnool,D CHAND BASHA,Independent,2605,0,2605,11
Andhra Pradesh,Kurnool,D YUGANDHAR,Independent,2820,0,2820,12
Andhra Pradesh,Kurnool,None of the Above,NOTA,9369,16,9385,13
Andhra Pradesh,Anantapur,ANIL CHOWDARY.  P,Indian National Congress,16696,23,16719,1
Andhra Pradesh,Anantapur,KASANI NAGARAJU,Bahujan Samaj Party,6218,9,6227,2
Andhra Pradesh,Anantapur,J.C. DIVAKAR REDDI,Telugu Desam,606849,3439,610288,3
Andhra Pradesh,Anantapur,ANANTHA VENKATARAMIREDDY,Yuvajana Sramika Rythu Congress Party,545612,2685,548297,4
Andhra Pradesh,Anantapur,T.KULDEEP CHOWDARY,STR,6542,0,6542,5
Andhra Pradesh,Anantapur,PAVAN KUMAR,Pyramid Party of India,2073,3,2076,6
Andhra Pradesh,Anantapur,BUZIREDDY VENUGOPAL REDDY,ICSP,1383,5,1388,7
Andhra Pradesh,Anantapur,BOYA ANIL KUMAR,Jai Samaikyandhra Party,2776,24,2800,8
Andhra Pradesh,Anantapur,G. LALITHA,SOCIALIST UNITY CENTRE OF INDIA (COMMUNIST),945,7,952,9
Andhra Pradesh,Anantapur,G. NAGARAJU,Independent,1095,0,1095,10
Andhra Pradesh,Anantapur,B. SRINIVASULU,Independent,1594,5,1599,11
Andhra Pradesh,Anantapur,SHAIK. MOHAMMAD SHAFI.,Independent,3017,14,3031,12
Andhra Pradesh,Anantapur,D. SOMANATH,Independent,2273,1,2274,13
Andhra Pradesh,Anantapur,None of the Above,NOTA,8776,81,8857,14
Andhra Pradesh,Hindupur,KRISTAPPA NIMMALA,Telugu Desam,600507,3784,604291,1
Andhra Pradesh,Hindupur,G.C VENKATARAMUDU,Indian National Congress,36297,155,36452,2
Andhra Pradesh,Hindupur,ANAND,Pyramid Party of India,3100,1,3101,3
Andhra Pradesh,Hindupur,AMUDALA SUBRAMANYAM,RPS,4430,91,4521,4
Andhra Pradesh,Hindupur,DUDDUKUNTA SREEDHAR REDDY,Yuvajana Sramika Rythu Congress Party,504636,2330,506966,5
Andhra Pradesh,Hindupur,K.MOHAMMAD SHAMEER BASHA,Jai Samaikyandhra Party,4566,24,4590,6
Andhra Pradesh,Hindupur,APPIREDDYGARI KONDA REDDY,Independent,1257,0,1257,7
Andhra Pradesh,Hindupur,ASADULLAH K.M,Independent,1095,4,1099,8
Andhra Pradesh,Hindupur,CHINTA SARATH KUMAR REDDY,Independent,1270,5,1275,9
Andhra Pradesh,Hindupur,K.PEDDA REDDI,Independent,1150,2,1152,10
Andhra Pradesh,Hindupur,MADDIPATLA SUDHAKAR NAIDU,Independent,2331,1,2332,11
Andhra Pradesh,Hindupur,D. SOMANATH,Independent,2030,2,2032,12
Andhra Pradesh,Hindupur,None of the Above,NOTA,8114,75,8189,13
Andhra Pradesh,Kadapa,AJAYA KUMAR VEENA,Indian National Congress,14164,155,14319,1
Andhra Pradesh,Kadapa,MALIKIREDDY. HANUMANTHA REDDY,Bahujan Samaj Party,5492,23,5515,2
Andhra Pradesh,Kadapa,SRINIVASA REDDY REDDEPPAGARI,Telugu Desam,477505,4155,481660,3
Andhra Pradesh,Kadapa,Y.S. AVINASH REDDY,Yuvajana Sramika Rythu Congress Party,665491,6492,671983,4
Andhra Pradesh,Kadapa,YELLIPALEM RAMESH.REDDY,Janata Dal (United),3795,14,3809,5
Andhra Pradesh,Kadapa,GAJJALA.RAMA SUBBA REDDY,Pyramid Party of India,1771,50,1821,6
Andhra Pradesh,Kadapa,PUTHA. LAKSHMI REDDY,All India Forward Bloc,894,39,933,7
Andhra Pradesh,Kadapa,B. PULLAIAH,ANC,2550,15,2565,8
Andhra Pradesh,Kadapa,RACHINENI. VENUGOPAL,Rashtriya Praja Congress (Secular),1024,10,1034,9
Andhra Pradesh,Kadapa,G.V.A.K. REDDY,Janata Dal (Secular),885,3,888,10
Andhra Pradesh,Kadapa,VARADI SOBHARANI,DABAP,2226,14,2240,11
Andhra Pradesh,Kadapa,DR. SHAIK GHOUSE PEER,Jai Samaikyandhra Party,3131,88,3219,12
Andhra Pradesh,Kadapa,SAJID HUSSAIN,Aam Aadmi Party,3318,83,3401,13
Andhra Pradesh,Kadapa,POREDDY PRABHAKARA REDDY,Independent,1202,15,1217,14
Andhra Pradesh,Kadapa,None of the Above,NOTA,5944,114,6058,15
Andhra Pradesh,Nellore,ADALA PRABHAKARA REDDY,Telugu Desam,558730,4188,562918,1
Andhra Pradesh,Nellore,NARAYANA REDDY VAKATI,Indian National Congress,22760,110,22870,2
Andhra Pradesh,Nellore,PATTAPU RAVI,Bahujan Samaj Party,3228,71,3299,3
Andhra Pradesh,Nellore,KOLATI GOPINATH,Pyramid Party of India,996,3,999,4
Andhra Pradesh,Nellore,CHEMIKALA TIRUPATI,ARPS,1423,1,1424,5
Andhra Pradesh,Nellore,CHANDRA SEKHAR YADAV,Rajyadhikara Party,4106,6,4112,6
Andhra Pradesh,Nellore,MEKAPATI RAJAMOHAN REDDY,Yuvajana Sramika Rythu Congress Party,573203,3193,576396,7
Andhra Pradesh,Nellore,SYED HANEEF,Jai Samaikyandhra Party,5530,48,5578,8
Andhra Pradesh,Nellore,ANANDA RAO SOMPALLI,Independent,759,1,760,9
Andhra Pradesh,Nellore,NAVEEN SUKPALLI,Independent,626,0,626,10
Andhra Pradesh,Nellore,PANDHITI SUBBAIAH,Independent,736,0,736,11
Andhra Pradesh,Nellore,MALLI VENKATESWARLU,Independent,685,1,686,12
Andhra Pradesh,Nellore,MALYADRI RAVULAKOLLU,Independent,875,0,875,13
Andhra Pradesh,Nellore,MEDA MALLA REDDY,Independent,820,0,820,14
Andhra Pradesh,Nellore,None of the Above,NOTA,5491,58,5549,15
Andhra Pradesh,Tirupati ,KARUMANCHI JAYARAM,Bharatiya Janata Party,539887,3064,542951,1
Andhra Pradesh,Tirupati ,KOTHAPALLI SUBRAMANYAM,Communist Party of India  (Marxist),11096,72,11168,2
Andhra Pradesh,Tirupati ,CHINTA MOHAN,Indian National Congress,33121,212,33333,3
Andhra Pradesh,Tirupati ,"DR. U RAMACHANDRA, M.B.B.S",Bahujan Samaj Party,5985,51,6036,4
Andhra Pradesh,Tirupati ,DEGALA SURYA NARAYANA,Pyramid Party of India,2861,14,2875,5
Andhra Pradesh,Tirupati ,NEERUGUTTA NAGESWARA,Aam Aadmi Party,7240,40,7280,6
Andhra Pradesh,Tirupati ,VARAPRASAD RAO VELAGAPALLI,Yuvajana Sramika Rythu Congress Party,578289,2087,580376,7
Andhra Pradesh,Tirupati ,M SOLMON,ARPS,9807,8,9815,8
Andhra Pradesh,Tirupati ,KATTAMANCHI PRABHAKAR,Independent,1446,9,1455,9
Andhra Pradesh,Tirupati ,KALAVAPALLI SAHADEVAIAH,Independent,2502,8,2510,10
Andhra Pradesh,Tirupati ,THYDULA SUBBARAMAIAH,Independent,1402,1,1403,11
Andhra Pradesh,Tirupati ,NUNE VENGAIAH,Independent,1827,2,1829,12
Andhra Pradesh,Tirupati ,K.S. MUNIRATHNAM,Independent,1692,4,1696,13
Andhra Pradesh,Tirupati ,SONGA RATNAMMA,Independent,1644,1,1645,14
Andhra Pradesh,Tirupati ,None of the Above,NOTA,8619,71,8690,15
Andhra Pradesh,Rajampet,ANNAYYAGARI SAI PRATHAP,Indian National Congress,29247,85,29332,1
Andhra Pradesh,Rajampet,D.  PURANDESWARI,Bharatiya Janata Party,424885,2105,426990,2
Andhra Pradesh,Rajampet,VENKATA SUBBAIAH NALLUGARI,Bahujan Samaj Party,8172,17,8189,3
Andhra Pradesh,Rajampet,N.  DEVA,Hindustan Janta Party,3895,1,3896,4
Andhra Pradesh,Rajampet,S NARENDRA BABU,MaSP,15075,11,15086,5
Andhra Pradesh,Rajampet,P.V.MIDHUN REDDY,Yuvajana Sramika Rythu Congress Party,599650,2102,601752,6
Andhra Pradesh,Rajampet,G.MUJEEB HUSSAIN,Jai Samaikyandhra Party,59648,129,59777,7
Andhra Pradesh,Rajampet,V PATTABHI,Independent,3545,4,3549,8
Andhra Pradesh,Rajampet,SHAIK JEELANI SAHEB,Independent,2623,7,2630,9
Andhra Pradesh,Rajampet,None of the Above,NOTA,7095,21,7116,10
Andhra Pradesh,Chittoor ,JITHENDRA KUMAR.DHANDU,Bahujan Samaj Party,15851,46,15897,1
Andhra Pradesh,Chittoor ,NARAMALLI SIVAPRASAD,Telugu Desam,590938,3924,594862,2
Andhra Pradesh,Chittoor ,DR.B.RAJAGOPAL,Indian National Congress,16505,67,16572,3
Andhra Pradesh,Chittoor ,UDAYA C.S,Pyramid Party of India,3793,10,3803,4
Andhra Pradesh,Chittoor ,P. PUSHPA RAJ,Jai Samaikyandhra Party,5628,112,5740,5
Andhra Pradesh,Chittoor ,G.SAMANYAKIRAN,Yuvajana Sramika Rythu Congress Party,548184,2540,550724,6
Andhra Pradesh,Chittoor ,S. ANJAPPA,Independent,4314,7,4321,7
Andhra Pradesh,Chittoor ,None of the Above,NOTA,6940,56,6996,8
Arunachal Pradesh,ARUNACHAL WEST,GICHO KABAK,Nationalist Congress Party,5910,155,6065,1
Arunachal Pradesh,ARUNACHAL WEST,GUMJUM HAIDER,All India Trinamool Congress,8832,303,9135,2
Arunachal Pradesh,ARUNACHAL WEST,JALLEY SONAM,People's Party of Arunachal,13979,685,14664,3
Arunachal Pradesh,ARUNACHAL WEST,KIREN RIJIJU,Bharatiya Janata Party,162575,6792,169367,4
Arunachal Pradesh,ARUNACHAL WEST,TAKAM SANJOY,Indian National Congress,125908,1721,127629,5
Arunachal Pradesh,ARUNACHAL WEST,HABUNG PAYENG,Aam Aadmi Party,3519,128,3647,6
Arunachal Pradesh,ARUNACHAL WEST,TABA TAKU,LB,941,39,980,7
Arunachal Pradesh,ARUNACHAL WEST,SUBU KECHI,Independent,2328,34,2362,8
Arunachal Pradesh,ARUNACHAL WEST,None of the Above,NOTA,1804,12,1816,9
Arunachal Pradesh,ARUNACHAL EAST,NINONG ERING,Indian National Congress,116347,2108,118455,1
Arunachal Pradesh,ARUNACHAL EAST,TAPIR GAO,Bharatiya Janata Party,102463,3514,105977,2
Arunachal Pradesh,ARUNACHAL EAST,WANGMAN LOWANGCHA,People's Party of Arunachal,31698,656,32354,3
Arunachal Pradesh,ARUNACHAL EAST,None of the Above,NOTA,4460,45,4505,4
Assam,Karimganj ,KRISHNA DAS,Bharatiya Janata Party,260347,425,260772,1
Assam,Karimganj ,RABINDRA NATH CHOUDHURY,Asom Gana Parishad,5550,6,5556,2
Assam,Karimganj ,RADHESHYAM BISWAS,AIUDF,362605,261,362866,3
Assam,Karimganj ,LALIT MOHON SUKLABAIDYA,Indian National Congress,226064,498,226562,4
Assam,Karimganj ,TARUN KUMAR DAS,Aam Aadmi Party,3652,6,3658,5
Assam,Karimganj ,PROBASH CH. SARKAR,SOCIALIST UNITY CENTRE OF INDIA (COMMUNIST),3112,2,3114,6
Assam,Karimganj ,RINKU MALAKAR,Samajwadi Party,2274,1,2275,7
Assam,Karimganj ,GOUTAM MALAKAR,Independent,2447,0,2447,8
Assam,Karimganj ,PINTU MALAKAR,Independent,1662,2,1664,9
Assam,Karimganj ,PRADIP SUKLABAIDYA,Independent,2391,1,2392,10
Assam,Karimganj ,MAHANANDA DAS,Independent,1590,2,1592,11
Assam,Karimganj ,SAJALENDU MALAKAR,Independent,2465,0,2465,12
Assam,Karimganj ,SANJIT KUMAR DAS,Independent,1880,0,1880,13
Assam,Karimganj ,SABUJ DAS,Independent,1974,0,1974,14
Assam,Karimganj ,SUJIT MALLICK,Independent,3437,0,3437,15
Assam,Karimganj ,None of the Above,NOTA,4254,12,4266,16
Assam,Silchar,KABINDRA PURKAYASTHA,Bharatiya Janata Party,301159,51,301210,1
Assam,Silchar,KUTUB AHMED MAZUMDER,AIUDF,85530,0,85530,2
Assam,Silchar,BIJOY KRISHNA NATH,Asom Gana Parishad,7679,0,7679,3
Assam,Silchar,REJAMOND ALI BARBHUIYA,Communist Party of India  (Marxist),12458,2,12460,4
Assam,Silchar,SUSHMITA DEV  ,Indian National Congress,336426,25,336451,5
Assam,Silchar,ARUNANGSHU BHATTACHARJEE,SOCIALIST UNITY CENTRE OF INDIA (COMMUNIST),8593,2,8595,6
Assam,Silchar,ABDUL MANNAN BARBHUIYA,Aam Aadmi Party,3114,4,3118,7
Assam,Silchar,WAZID REJA OSMANI,All India Trinamool Congress,8282,0,8282,8
Assam,Silchar,NILU MANDOL,Shivsena,1922,0,1922,9
Assam,Silchar,RASHID AHMED LASKAR,Samajwadi Party,3347,0,3347,10
Assam,Silchar,UPENDRA CHANDRA DAS,Independent,2740,0,2740,11
Assam,Silchar,KAMAL DAS,Independent,2170,0,2170,12
Assam,Silchar,JAYANTA MALLICK,Independent,1605,0,1605,13
Assam,Silchar,NIRUPAM MANDAL,Independent,2462,0,2462,14
Assam,Silchar,MADHU SUDHAN DAS,Independent,3151,0,3151,15
Assam,Silchar,SHUVADIP DATTA,Independent,8577,0,8577,16
Assam,Silchar,SUKAMAL DAS,Independent,6221,0,6221,17
Assam,Silchar,None of the Above,NOTA,4310,0,4310,18
Assam,Autonomous District,JOY RAM ENGLENG,Bharatiya Janata Party,188917,140,189057,1
Assam,Autonomous District,BIREN SINGH ENGTI,Indian National Congress,213038,114,213152,2
Assam,Autonomous District,ASHWENG J. RENGMA,Jharkhand Mukti Morcha,9260,3,9263,3
Assam,Autonomous District,PRATIMA ENGHEEPI,Communist Party of India (Marxist-Lenninist) (Liberation),11755,7,11762,4
Assam,Autonomous District,CHOMANG KRO,Independent,108248,51,108299,5
Assam,Autonomous District,None of the Above,NOTA,11744,3,11747,6
Assam,Dhubri,ANOWAR HUSSAIN,Asom Gana Parishad,9892,5,9897,1
Assam,Dhubri,WAZED ALI CHOUDHURY,Indian National Congress,362676,163,362839,2
Assam,Dhubri,DR. DEBAMOY SANYAL,Bharatiya Janata Party,298897,88,298985,3
Assam,Dhubri,BADRUDDIN AJMAL,AIUDF,592338,231,592569,4
Assam,Dhubri,AZMAL HUSSAIN,Aam Aadmi Party,4467,1,4468,5
Assam,Dhubri,YOUSUB ALI AHMED,Samajwadi Party,3277,0,3277,6
Assam,Dhubri,KASIR UDDIN SK.,Indian Union Muslim League,1455,0,1455,7
Assam,Dhubri,SURAT JAMAN MONDAL,SOCIALIST UNITY CENTRE OF INDIA (COMMUNIST),5932,3,5935,8
Assam,Dhubri,ZESMINA KHATUN,All India Trinamool Congress,7871,3,7874,9
Assam,Dhubri,ALI HUSSAIN,Independent,23814,2,23816,10
Assam,Dhubri,KASHEM ALI AKONDA,Independent,2783,2,2785,11
Assam,Dhubri,MONIRUL HUSSAIN,Independent,2722,1,2723,12
Assam,Dhubri,MOHAR UDDIN MONDAL,Independent,40207,1,40208,13
Assam,Dhubri,MOHENDRA CHANDRA ROY,Independent,4606,1,4607,14
Assam,Dhubri,RAM EKBAL SHAHANI,Independent,2375,0,2375,15
Assam,Dhubri,None of the Above,NOTA,5811,0,5811,16
Assam,Kokrajhar,CHANDAN BRAHMA,BOPF,243719,40,243759,1
Assam,Kokrajhar,RANJIT SHEKHAR MOOSHAHARY,All India Trinamool Congress,17523,14,17537,2
Assam,Kokrajhar,URKHAO GWRA BRAHMA,Independent,278381,268,278649,3
Assam,Kokrajhar,NABA KUMAR SARANIA (HIRA),Independent,634111,317,634428,4
Assam,Kokrajhar,SABDA RAM RABHA,Independent,20069,5,20074,5
Assam,Kokrajhar,SANSUMA KHUNGGUR BWISWMUTHIARY,Independent,11233,6,11239,6
Assam,Kokrajhar,None of the Above,NOTA,18178,5,18183,7
Assam,Barpeta,ISMAIL HUSSAIN,Indian National Congress,277611,191,277802,1
Assam,Barpeta,UDDHAB BARMAN,Communist Party of India  (Marxist),27539,36,27575,2
Assam,Barpeta,CHANDRA MOHAN PATOWARY,Bharatiya Janata Party,352239,122,352361,3
Assam,Barpeta,SIRAJ UDDIN AJMAL,AIUDF,394580,122,394702,4
Assam,Barpeta,PHANI BHUSAN CHOUDHURY,Asom Gana Parishad,73702,31,73733,5
Assam,Barpeta,ABUL AWAL,Samajwadi Party,3099,0,3099,6
Assam,Barpeta,ENTAZ ALI,LB,1937,0,1937,7
Assam,Barpeta,KHURSHIDA ANOWARA BEGUM,SOCIALIST UNITY CENTRE OF INDIA (COMMUNIST),5710,0,5710,8
Assam,Barpeta,DR. PERVEZ ALI AHMED,All India Trinamool Congress,10939,5,10944,9
Assam,Barpeta,KAMAL UDDIN,Independent,3432,1,3433,10
Assam,Barpeta,GAUTAM KUMAR SARMA,Independent,1858,1,1859,11
Assam,Barpeta,SAMSUL HOQUE,Independent,24444,0,24444,12
Assam,Barpeta,DILIR KHAN,Independent,20135,0,20135,13
Assam,Barpeta,BARUN KARMAKAR,Independent,1649,0,1649,14
Assam,Barpeta,BHADRESWAR BARMAN,Independent,1694,1,1695,15
Assam,Barpeta,None of the Above,NOTA,4784,1,4785,16
Assam,Gauhati,GOPI NATH DAS,AIUDF,137252,2,137254,1
Assam,Gauhati,BIJOYA CHAKRAVARTY,Bharatiya Janata Party,764904,81,764985,2
Assam,Gauhati,BIRENDRA PRASAD BAISHYA,Asom Gana Parishad,86540,6,86546,3
Assam,Gauhati,MANASH BORAH,Indian National Congress,449180,21,449201,4
Assam,Gauhati,KAZI NEKIB AHMED,rdsc,6636,0,6636,5
Assam,Gauhati,GOPI BARUAH,LB,2411,0,2411,6
Assam,Gauhati,PRANJAL BORDOLOY,Aam Aadmi Party,4809,0,4809,7
Assam,Gauhati,BANDANA BARMAN BARUAH,Samajwadi Party,3240,0,3240,8
Assam,Gauhati,BIJU PHUKAN,All India Trinamool Congress,8161,1,8162,9
Assam,Gauhati,ANIL BHAGAWATI,Independent,5782,0,5782,10
Assam,Gauhati,AJAD ALI,Independent,2384,1,2385,11
Assam,Gauhati,KHARGESWAR DAS,Independent,2532,0,2532,12
Assam,Gauhati,MD. ZAKIR HUSSAIN,Independent,2275,0,2275,13
Assam,Gauhati,DHIRAJ MEDHI,Independent,2845,0,2845,14
Assam,Gauhati,PADMESHWAR PHUKAN,Independent,2628,1,2629,15
Assam,Gauhati,PRADIP KALITA,Independent,7345,0,7345,16
Assam,Gauhati,DR. FARUK AAHAMMED BHUYAN,Independent,3540,0,3540,17
Assam,Gauhati,BENEDICT ALOK ARENG,Independent,12432,0,12432,18
Assam,Gauhati,None of the Above,NOTA,6720,0,6720,19
Assam,Mangaldoi,KIRIP CHALIHA,Indian National Congress,463430,43,463473,1
Assam,Mangaldoi,PARESH BAISHYA,AIUDF,74710,0,74710,2
Assam,Mangaldoi,MADHAB RAJBANGSHI,Asom Gana Parishad,66455,12,66467,3
Assam,Mangaldoi,RAMEN DEKA,Bharatiya Janata Party,486230,127,486357,4
Assam,Mangaldoi,SAHADEV DAS,BOPF,86344,3,86347,5
Assam,Mangaldoi,AROON BAROOA,rdsc,4164,0,4164,6
Assam,Mangaldoi,DEBA KUMAR BARMAN,All India Trinamool Congress,8341,0,8341,7
Assam,Mangaldoi,NAMRATA SARMA,Aam Aadmi Party,3424,0,3424,8
Assam,Mangaldoi,RATUL KUMAR CHOUDHURY,Samajwadi Party,3658,0,3658,9
Assam,Mangaldoi,SWARNALATA CHALIHA,SOCIALIST UNITY CENTRE OF INDIA (COMMUNIST),7600,0,7600,10
Assam,Mangaldoi,SAHNUR ALI,Independent,5531,0,5531,11
Assam,Mangaldoi,SHACHINDRA NATH BRAHMA,Independent,12443,0,12443,12
Assam,Mangaldoi,None of the Above,NOTA,10719,3,10722,13
Assam,Tezpur,BHUPEN KUMAR BORAH,Indian National Congress,360457,34,360491,1
Assam,Tezpur,JOSEPH TOPPO,Asom Gana Parishad,40487,2,40489,2
Assam,Tezpur,RAM PRASAD SARMAH,Bharatiya Janata Party,446406,105,446511,3
Assam,Tezpur,KHEMRAJ CHETRY,Communist Party of India  (Marxist),24907,3,24910,4
Assam,Tezpur,GOPI CHAND SHAHABADI,All India Trinamool Congress,8710,2,8712,5
Assam,Tezpur,RAJEN SAIKIA,All India Forward Bloc,4245,1,4246,6
Assam,Tezpur,LAKSHIKANTA KURMI,Communist Party of India (Marxist-Lenninist) (Liberation),10725,0,10725,7
Assam,Tezpur,ELIAS KUJUR,Independent,5207,0,5207,8
Assam,Tezpur,MONI KUMAR SUBBA,Independent,62714,16,62730,9
Assam,Tezpur,None of the Above,NOTA,16666,1,16667,10
Assam,Nowgong,DR. ADITYA LANGTHASA,AIUDF,313976,36,314012,1
Assam,Nowgong,JONJONALI BARUAH,Indian National Congress,350413,174,350587,2
Assam,Nowgong,MRIDULA BARKAKOTY,Asom Gana Parishad,35132,10,35142,3
Assam,Nowgong,RAJEN GOHAIN ,Bharatiya Janata Party,494005,141,494146,4
Assam,Nowgong,DIPAK KUMAR BORAH,All India Trinamool Congress,6835,0,6835,5
Assam,Nowgong,RAFIQUL ISLAM,All India Forward Bloc,2782,1,2783,6
Assam,Nowgong,SELIMA SULTANA,Independent,6462,0,6462,7
Assam,Nowgong,FARUK HAZARIKA,Independent,11325,0,11325,8
Assam,Nowgong,None of the Above,NOTA,8779,3,8782,9
Assam,Kaliabor,DR. ARUN KUMAR SARMA,Asom Gana Parishad,78042,90,78132,1
Assam,Kaliabor,GOURAV GOGOI,Indian National Congress,443032,283,443315,2
Assam,Kaliabor,BIJOY KUMAR TIRU,AIUDF,231281,14,231295,3
Assam,Kaliabor,MRINAL KUMAR SAIKIA,Bharatiya Janata Party,349262,179,349441,4
Assam,Kaliabor,ARUP KUMAR MAHANTA,Communist Party of India (Marxist-Lenninist) (Liberation),5431,2,5433,5
Assam,Kaliabor,SAMSUL ALAM,All India Trinamool Congress,6538,0,6538,6
Assam,Kaliabor,JINTI GOGOI,Aam Aadmi Party,2581,3,2584,7
Assam,Kaliabor,MITHUAL KUMAR,All India Forward Bloc,2963,3,2966,8
Assam,Kaliabor,SAHABA AHMED,Independent,2409,2,2411,9
Assam,Kaliabor,JITEN GOGOI,Independent,8271,0,8271,10
Assam,Kaliabor,BINOD GOGOI,Independent,9583,0,9583,11
Assam,Kaliabor,MONTU SAIKIA,Independent,9132,1,9133,12
Assam,Kaliabor,RAHMAT ULLAH,Independent,4985,0,4985,13
Assam,Kaliabor,None of the Above,NOTA,12399,4,12403,14
Assam,Jorhat,KAMAKHYA PRASAD TASA,Bharatiya Janata Party,456170,250,456420,1
Assam,Jorhat,DRUPAD BORGOHAIN,Communist Party of India,28909,21,28930,2
Assam,Jorhat,NASIR AHMED,AIUDF,7331,0,7331,3
Assam,Jorhat,PRODIP HAZARIKA,Asom Gana Parishad,46588,38,46626,4
Assam,Jorhat,BIJOY KRISHNA HANDIQUE,Indian National Congress,353851,149,354000,5
Assam,Jorhat,GUNIN BASUMATARI,Samajwadi Party,5754,0,5754,6
Assam,Jorhat,MANOROM GOGOI,Aam Aadmi Party,3656,3,3659,7
Assam,Jorhat,RIBULAYA GOGOI,All India Trinamool Congress,5759,0,5759,8
Assam,Jorhat,HOREN BORGOHAIN,All India Forward Bloc,3472,0,3472,9
Assam,Jorhat,RAJ KUMAR DOWARAH,Independent,4737,0,4737,10
Assam,Jorhat,None of the Above,NOTA,14645,3,14648,11
Assam,Dibrugarh,ANUP PHUKON,Asom Gana Parishad,45697,13,45710,1
Assam,Dibrugarh,PABAN SINGH GHATOWAR,Indian National Congress,308977,40,309017,2
Assam,Dibrugarh,RAMESWAR TELI,Bharatiya Janata Party,494278,86,494364,3
Assam,Dibrugarh,CHENI RAM MORAN,All India Forward Bloc,7111,1,7112,4
Assam,Dibrugarh,NAVAJYOTI KALITA,All India Trinamool Congress,8580,2,8582,5
Assam,Dibrugarh,SUBHAS SEN,Communist Party of India (Marxist-Lenninist) (Liberation),9373,1,9374,6
Assam,Dibrugarh,None of the Above,NOTA,16808,1,16809,7
Assam,Lakhimpur,MAMUN IMDADUL HAQUE CHAWDHURY,AIUDF,37336,7,37343,1
Assam,Lakhimpur,RANEE NARAH,Indian National Congress,320305,100,320405,2
Assam,Lakhimpur,SARBANANDA SONOWAL,Bharatiya Janata Party,612134,409,612543,3
Assam,Lakhimpur,HARI PRASAD DIHINGIA,Asom Gana Parishad,81704,49,81753,4
Assam,Lakhimpur,TANISH ORANG,Communist Party of India (Marxist-Lenninist) (Liberation),4720,1,4721,5
Assam,Lakhimpur,DHEBOR GOHAIN BORUAH,All India Trinamool Congress,9093,2,9095,6
Assam,Lakhimpur,DR. HIRAMONI DEKA SONOWAL,Aam Aadmi Party,2893,0,2893,7
Assam,Lakhimpur,HEM KANTA MIRI,SOCIALIST UNITY CENTRE OF INDIA (COMMUNIST),6894,2,6896,8
Assam,Lakhimpur,KESHAB GOGOI,Independent,2752,0,2752,9
Assam,Lakhimpur,KHAIRUL ISLAM,Independent,4118,1,4119,10
Assam,Lakhimpur,DAVID HORO,Independent,5902,1,5903,11
Assam,Lakhimpur,RANJIT SINGH GORH,Independent,6335,0,6335,12
Assam,Lakhimpur,HRISHIKESH BARUAH,Independent,6013,0,6013,13
Assam,Lakhimpur,None of the Above,NOTA,11203,1,11204,14
Bihar,Valmiki Nagar,PURNMASI RAM,Indian National Congress,246116,102,246218,1
Bihar,Valmiki Nagar,BAIDYA NATH PRASAD MAHATO,Janata Dal (United),81593,19,81612,2
Bihar,Valmiki Nagar,SHAILESH KUMAR DIWAKAR,Bahujan Samaj Party,11667,1,11668,3
Bihar,Valmiki Nagar,SATISH CHANDRA DUBEY,Bharatiya Janata Party,363860,153,364013,4
Bihar,Valmiki Nagar,AMAR SAHANI,BED,35888,0,35888,5
Bihar,Valmiki Nagar,PROF. AMARESH PRASAD,Jharkhand Mukti Morcha,27603,0,27603,6
Bihar,Valmiki Nagar,DACTAR MAHTO,Jan Parishad,5524,1,5525,7
Bihar,Valmiki Nagar,DHARMESH PRASAD VARMA,Aam Aadmi Party,6008,0,6008,8
Bihar,Valmiki Nagar,VIRENDRA PRASAD GUPTA,Communist Party of India (Marxist-Lenninist) (Liberation),12581,0,12581,9
Bihar,Valmiki Nagar,OM SHANTI BABA,Independent,4371,0,4371,10
Bihar,Valmiki Nagar,DILIP VARMA,Independent,58804,13,58817,11
Bihar,Valmiki Nagar,DRAVYAN URAON,Independent,8013,0,8013,12
Bihar,Valmiki Nagar,NANDLAL RAM,Independent,10786,0,10786,13
Bihar,Valmiki Nagar,MANOHAR MANOJ,Independent,11509,0,11509,14
Bihar,Valmiki Nagar,None of the Above,NOTA,15515,0,15515,15
Bihar,Paschim Champaran,PRAKASH JHA,Janata Dal (United),260935,43,260978,1
Bihar,Paschim Champaran,PRABHU RAJ NARAIN RAO,Communist Party of India  (Marxist),17156,1,17157,2
Bihar,Paschim Champaran,RAGHUNATH JHA,Rashtriya Janata Dal,121787,13,121800,3
Bihar,Paschim Champaran,DR. SANJAY JAISWAL,Bharatiya Janata Party,371138,94,371232,4
Bihar,Paschim Champaran,SYED SHAMIM AKHTAR,Bahujan Samaj Party,12410,5,12415,5
Bihar,Paschim Champaran,ANAND KAUSHAL SINGH,Aam Aadmi Party,4296,1,4297,6
Bihar,Paschim Champaran,SUNIL KUMAR RAO,Communist Party of India (Marxist-Lenninist) (Liberation),4940,0,4940,7
Bihar,Paschim Champaran,ANAND PRASAD,Independent,5818,0,5818,8
Bihar,Paschim Champaran,NAFISH AHAMAD,Independent,10502,0,10502,9
Bihar,Paschim Champaran,MOHAN KUMAR,Independent,11260,0,11260,10
Bihar,Paschim Champaran,RATAN KUMAR SARKAR,Independent,6474,0,6474,11
Bihar,Paschim Champaran,SYED IRSHAD AKHTAR,Independent,9122,1,9123,12
Bihar,Paschim Champaran,None of the Above,NOTA,18803,1,18804,13
Bihar,Purvi Champaran,AVANEESH KUMAR SINGH,Janata Dal (United),128604,0,128604,1
Bihar,Purvi Champaran,BINOD KUMAR SRIVASTAVA,Rashtriya Janata Dal,208283,6,208289,2
Bihar,Purvi Champaran,RADHA MOHAN SINGH,Bharatiya Janata Party,400435,17,400452,3
Bihar,Purvi Champaran,SURESH PASWAN,Bahujan Samaj Party,10356,0,10356,4
Bihar,Purvi Champaran,ANIL KUMAR SINGH,Jai Maha Bharath Party,2819,0,2819,5
Bihar,Purvi Champaran,AMIT KUMAR CHOUBEY,Aam Aadmi Party,7512,0,7512,6
Bihar,Purvi Champaran,MD. NASIRUDDIN,JDR,2607,0,2607,7
Bihar,Purvi Champaran,PAWAN KUMAR,KS,2946,0,2946,8
Bihar,Purvi Champaran,PARAS NATH PANDEY,Jan Parishad,3027,0,3027,9
Bihar,Purvi Champaran,MOQIM ANSARI,Jammu & Kashmir National Panthers Party,2811,0,2811,10
Bihar,Purvi Champaran,RAGHUNATH GUPTA,Samajwadi Party,2459,0,2459,11
Bihar,Purvi Champaran,SHATRUGHAN TIWARI,BJKVP,4893,0,4893,12
Bihar,Purvi Champaran,DILIP SINGH,Independent,10759,0,10759,13
Bihar,Purvi Champaran,PRAMOD KUMAR PANDEY,Independent,10505,0,10505,14
Bihar,Purvi Champaran,SHAMBHU DAS,Independent,11371,0,11371,15
Bihar,Purvi Champaran,None of the Above,NOTA,13261,0,13261,16
Bihar,Sheohar,ANGESH KUMAR,Bahujan Samaj Party,26443,3,26446,1
Bihar,Sheohar,MD ANWARUL HAQUE,Rashtriya Janata Dal,236180,87,236267,2
Bihar,Sheohar,RAMA DEVI,Bharatiya Janata Party,372388,118,372506,3
Bihar,Sheohar,SHAHID ALI KHAN,Janata Dal (United),79099,9,79108,4
Bihar,Sheohar,JAGRANATH SAHANI,SKLP,4398,1,4399,5
Bihar,Sheohar,JATA SHANKAR AATREY,ravp,4640,1,4641,6
Bihar,Sheohar,MD NASRUDDIN ANSARI,NaLP,3072,0,3072,7
Bihar,Sheohar,RAMASHANKAR SINGH,All India Forward Bloc,2845,0,2845,8
Bihar,Sheohar,RAM LOBHIT PASWAN,Bahujan Mukti Party,2647,1,2648,9
Bihar,Sheohar,LAXMAN PASWAN,Jharkhand Mukti Morcha,18681,0,18681,10
Bihar,Sheohar,LOVELY ANAND,Samajwadi Party,45999,9,46008,11
Bihar,Sheohar,SHATRUGHNA SAHU,Aam Aadmi Party,8254,2,8256,12
Bihar,Sheohar,RAMASHISH MAHTO,Independent,5941,0,5941,13
Bihar,Sheohar,SHIVANANDAN PRASAD,Independent,12161,0,12161,14
Bihar,Sheohar,SANJAY PRASAD,Independent,8245,0,8245,15
Bihar,Sheohar,None of the Above,NOTA,11670,0,11670,16
Bihar,Sitamarhi,ARJUN RAI,Janata Dal (United),97182,6,97188,1
Bihar,Sitamarhi,MAHESH KUMAR,Bahujan Samaj Party,8521,0,8521,2
Bihar,Sitamarhi,SITARAM YADAV,Rashtriya Janata Dal,263251,49,263300,3
Bihar,Sitamarhi,KISHORI DAS,Aam Aadmi Party,18040,3,18043,4
Bihar,Sitamarhi,JAY KUMAR CHAUDHARY,Lok Dal,3876,4,3880,5
Bihar,Sitamarhi,BHARAT BHUSHAN SAHNI,SKLP,2763,0,2763,6
Bihar,Sitamarhi,MAHENDRA PRASAD,Samajwadi Janata Party (Rashtriya),3694,1,3695,7
Bihar,Sitamarhi,RAJEEV RANJAN,All India Trinamool Congress,11249,1,11250,8
Bihar,Sitamarhi,RAM KUMAR SHARMA,BLSP,411222,43,411265,9
Bihar,Sitamarhi,SATYENDRA BHANDARI,Bahujan Mukti Party,7853,0,7853,10
Bihar,Sitamarhi,SURENDRA KUMAR,BJKVP,4501,0,4501,11
Bihar,Sitamarhi,SYED ABU DOJANA,Samajwadi Party,4692,0,4692,12
Bihar,Sitamarhi,AJAY KUMAR,Independent,5451,3,5454,13
Bihar,Sitamarhi,CHANDRIKA PRASAD,Independent,8846,0,8846,14
Bihar,Sitamarhi,NARENDRA MISHRA,Independent,6078,0,6078,15
Bihar,Sitamarhi,MAHESH NANDAN SINGH,Independent,20613,0,20613,16
Bihar,Sitamarhi,MOHAMMAD FAIYAZ AHMAD,Independent,7586,0,7586,17
Bihar,Sitamarhi,VINOD SAH,Independent,2996,0,2996,18
Bihar,Sitamarhi,SONE LAL SAH,Independent,6115,0,6115,19
Bihar,Sitamarhi,None of the Above,NOTA,5948,1,5949,20
Bihar,Madhubani,ABDUL BARI SIDDIQUI,Rashtriya Janata Dal,337459,46,337505,1
Bihar,Madhubani,PROF. GHULAM GHOUS,Janata Dal (United),56388,4,56392,2
Bihar,Madhubani,HARI NARAYAN YADAV,Bahujan Samaj Party,10115,0,10115,3
Bihar,Madhubani,HUKM DEO NARAYAN YADAV,Bharatiya Janata Party,357989,51,358040,4
Bihar,Madhubani,ANIRUD SAHU,Samajwadi Janata Party (Rashtriya),9474,0,9474,5
Bihar,Madhubani,KUMARI RITA,Shivsena,30942,0,30942,6
Bihar,Madhubani,DHRUB NARAYAN KARN,Communist Party of India (Marxist-Lenninist) (Liberation),6750,0,6750,7
Bihar,Madhubani,NEERAJ PATHAK,Aam Aadmi Party,9715,3,9718,8
Bihar,Madhubani,FAIZ AHMAD,JPJD,8464,0,8464,9
Bihar,Madhubani,RATNESHWAR JHA,AKBMP,6663,0,6663,10
Bihar,Madhubani,VIJAY KUMAR,Independent,7453,0,7453,11
Bihar,Madhubani,None of the Above,NOTA,18936,1,18937,12
Bihar,Jhanjharpur,DEVENDRA PRASAD YADAV,Janata Dal (United),183575,16,183591,1
Bihar,Jhanjharpur,MANGANI LAL MANDAL,Rashtriya Janata Dal,280024,49,280073,2
Bihar,Jhanjharpur,MANILAL SAHU,Bahujan Samaj Party,14188,2,14190,3
Bihar,Jhanjharpur,BIRENDRA KUMAR CHAUDHARY,Bharatiya Janata Party,335440,41,335481,4
Bihar,Jhanjharpur,MD. AKHTAR ALI,JPJD,9387,1,9388,5
Bihar,Jhanjharpur,TILIYA DEVI,Aam Aadmi Party,9440,1,9441,6
Bihar,Jhanjharpur,MD. FAIYAZ KHAN,JDR,5439,0,5439,7
Bihar,Jhanjharpur,VIGHNESH BHAGAT,Bahujan Mukti Party,3727,0,3727,8
Bihar,Jhanjharpur,BIPIN KUMAR JHA,BVM,7358,0,7358,9
Bihar,Jhanjharpur,HAIDAR,Vanchitsamaj Insaaf Party,5653,0,5653,10
Bihar,Jhanjharpur,AWDHESH KUMAR SHINGH,Independent,4248,0,4248,11
Bihar,Jhanjharpur,IBRAHIM ABBASI,Independent,4811,0,4811,12
Bihar,Jhanjharpur,CHANDRA MOHAN JHA,Independent,9823,0,9823,13
Bihar,Jhanjharpur,CHHEDI RAM,Independent,7632,0,7632,14
Bihar,Jhanjharpur,JANAK ROY,Independent,8689,0,8689,15
Bihar,Jhanjharpur,PAWAN KUMAR,Independent,17790,0,17790,16
Bihar,Jhanjharpur,BARUN KUMAR JHA,Independent,13833,0,13833,17
Bihar,Jhanjharpur,RAM CHANDRA SAFI,Independent,8083,0,8083,18
Bihar,Jhanjharpur,DR. BINAY KUMAR JHA,Independent,3956,0,3956,19
Bihar,Jhanjharpur,None of the Above,NOTA,8043,0,8043,20
Bihar,Supaul,AMAN KUMAR SAMAJSEVI,Bahujan Samaj Party,21233,0,21233,1
Bihar,Supaul,KAMESHWAR CHAUPAL,Bharatiya Janata Party,249687,6,249693,2
Bihar,Supaul,DILESHWAR KAMAIT,Janata Dal (United),273255,0,273255,3
Bihar,Supaul,RANJEET RANJAN,Indian National Congress,332925,2,332927,4
Bihar,Supaul,JAY NARAYAN YADAV,Communist Party of India (Marxist-Lenninist) (Liberation),11566,0,11566,5
Bihar,Supaul,DEV NARAYAN YADAV,Bahujan Mukti Party,4825,0,4825,6
Bihar,Supaul,PARMESHWAR JHA,Aam Aadmi Party,9604,0,9604,7
Bihar,Supaul,MOHAMMAD AMANULLAH,Indian Union Muslim League,5116,0,5116,8
Bihar,Supaul,SHAKALDEV MANDAL,Samajwadi Janata Party (Rashtriya),5964,0,5964,9
Bihar,Supaul,SURESH KUMAR AZAD,JHP,14754,0,14754,10
Bihar,Supaul,BINOD KUMAR SAHU,Independent,8908,0,8908,11
Bihar,Supaul,RAMDEV SHARMA,Independent,10687,0,10687,12
Bihar,Supaul,None of the Above,NOTA,21996,0,21996,13
Bihar,Araria,ABDUL RAHMAN,Bahujan Samaj Party,17724,0,17724,1
Bihar,Araria,TASLEEM UDDIN,Rashtriya Janata Dal,407975,3,407978,2
Bihar,Araria,PRADEEP KUMAR SINGH,Bharatiya Janata Party,261470,4,261474,3
Bihar,Araria,VIJAY KUMAR MANDAL,Janata Dal (United),221769,0,221769,4
Bihar,Araria,MD. ASLAM BEG,JDR,5149,0,5149,5
Bihar,Araria,CHANDRA BHUSHAN,Aam Aadmi Party,5685,0,5685,6
Bihar,Araria,RAJESH KUMAR,BVM,4646,0,4646,7
Bihar,Araria,RAMANAND RISHIDEO,Lok Dal,3411,0,3411,8
Bihar,Araria,BIDAYANAND PASWAN,Bahujan Mukti Party,3350,0,3350,9
Bihar,Araria,SANJAY KUMAR RISHIDEV,Communist Party of India (Marxist-Lenninist) (Liberation),5292,0,5292,10
Bihar,Araria,SAR WAT JAHRE ANSARI,Samajwadi Janata Party (Rashtriya),6376,0,6376,11
Bihar,Araria,ALAMDAR HUSSAIN,Independent,5645,0,5645,12
Bihar,Araria,PANKAJ KISHOR MANDAL,Independent,10704,0,10704,13
Bihar,Araria,None of the Above,NOTA,16608,0,16608,14
Bihar,Kishanganj,AKHTARUL IMAN,Janata Dal (United),55811,11,55822,1
Bihar,Kishanganj,DR DILIP  KUMAR JAISWAL,Bharatiya Janata Party,298762,87,298849,2
Bihar,Kishanganj,MD.NAUSHAD,Bahujan Samaj Party,14903,0,14903,3
Bihar,Kishanganj,MOHAMMAD ASRARUL HAQUE,Indian National Congress,493294,167,493461,4
Bihar,Kishanganj,ALIMUDDIN ANSARI,Aam Aadmi Party,15010,0,15010,5
Bihar,Kishanganj,MD. GULAB SIDDIKI,LKJP,5559,0,5559,6
Bihar,Kishanganj,MANUWER ALAM,JDR,5714,0,5714,7
Bihar,Kishanganj,MOHAMMAD WASIQUR RAHMAN,Indian Union Muslim League,5421,1,5422,8
Bihar,Kishanganj,CHITRANJAN SINGH,Independent,5152,0,5152,9
Bihar,Kishanganj,CHHOTE LAL MAHTO,Independent,11391,1,11392,10
Bihar,Kishanganj,None of the Above,NOTA,17205,1,17206,11
Bihar,Katihar,TARIQ ANWAR,Nationalist Congress Party,431172,120,431292,1
Bihar,Katihar,NIKHIL KUMAR CHOUDHARY,Bharatiya Janata Party,316415,137,316552,2
Bihar,Katihar,DR. RAM PRAKASH MAHTO,Janata Dal (United),100741,24,100765,3
Bihar,Katihar,SHIVENDRA KUMAR,Bahujan Samaj Party,2685,0,2685,4
Bihar,Katihar,ABDUR RAHMAN,Bharatiya Momin Front,2489,0,2489,5
Bihar,Katihar,MD. IQBAL AHMAD,Samajwadi Janata Party (Rashtriya),1553,0,1553,6
Bihar,Katihar,FULMANI HEMBRAM,BVM,3096,0,3096,7
Bihar,Katihar,BALESHWAR MARANDI,Jharkhand Mukti Morcha,33593,0,33593,8
Bihar,Katihar,BIBHAKER JHA @ VICTOR JHA,Aam Aadmi Party,4317,6,4323,9
Bihar,Katihar,MAHBUB ALAM,Communist Party of India (Marxist-Lenninist) (Liberation),9461,0,9461,10
Bihar,Katihar,MAHAMMAD HAMID MOBARAK,All India Trinamool Congress,8392,0,8392,11
Bihar,Katihar,MAHESH MANDAL,Bahujan Mukti Party,1980,0,1980,12
Bihar,Katihar,SATYANARAYAN BHAGAT,Pratap Shiv Sena,2550,0,2550,13
Bihar,Katihar,SURESH RAY,Rashtravadi Janata Party,4450,0,4450,14
Bihar,Katihar,ASHOK KUMAR,Independent,9000,0,9000,15
Bihar,Katihar,ASHOK KU BHAGAT,Independent,15547,0,15547,16
Bihar,Katihar,KANHAI MANDAL,Independent,10516,0,10516,17
Bihar,Katihar,MD. TARIQ ANWAR,Independent,4507,7,4514,18
Bihar,Katihar,NALINI MANDAL,Independent,7969,0,7969,19
Bihar,Katihar,RAJ KUMAR MANDAL,Independent,2141,0,2141,20
Bihar,Katihar,SANJAY SINGH,Independent,1675,0,1675,21
Bihar,Katihar,None of the Above,NOTA,3285,2,3287,22
Bihar,Purnia,AMARNATH TIWARI,Indian National Congress,124275,69,124344,1
Bihar,Purnia,UDAY SINGH ALIAS PAPPU SINGH,Bharatiya Janata Party,301979,178,302157,2
Bihar,Purnia,RAJ KUMAR ORAON,Bahujan Samaj Party,11195,1,11196,3
Bihar,Purnia,SANTOSH KUMAR,Janata Dal (United),418717,109,418826,4
Bihar,Purnia,ANIL KUMAR MAHTO,Jan Parishad,9162,0,9162,5
Bihar,Purnia,PANKAJ KUMAR SINGH,Communist Party of India (Marxist-Lenninist) (Liberation),7912,0,7912,6
Bihar,Purnia,PRAMOD NARAYAN PODDAR,BJJD,4662,2,4664,7
Bihar,Purnia,FAGU MARANDI,JDP,3439,1,3440,8
Bihar,Purnia,MANSUR ALAM,Samajwadi Party,3370,0,3370,9
Bihar,Purnia,MD SHAMSHER ALAM,Jharkhand Mukti Morcha,50446,0,50446,10
Bihar,Purnia,MD SHAHID AKHTAR,Bahujan Mukti Party,5137,0,5137,11
Bihar,Purnia,SYED SHAH EQBAL ALAM,BEMP,6324,0,6324,12
Bihar,Purnia,SUDEEP ROY,Aam Aadmi Party,16628,2,16630,13
Bihar,Purnia,MD AKHTAR ALI,Independent,5849,0,5849,14
Bihar,Purnia,KUNJ BIHARI PASWAN,Independent,8321,0,8321,15
Bihar,Purnia,NAVLESH PATHAK,Independent,18776,0,18776,16
Bihar,Purnia,SANJAY SINGH,Independent,9196,0,9196,17
Bihar,Purnia,None of the Above,NOTA,11980,2,11982,18
Bihar,Madhepura,GULJAR KUMAR,Bahujan Samaj Party,18084,0,18084,1
Bihar,Madhepura,RAJESH RANJAN @ PAPPU YADAV,Rashtriya Janata Dal,368876,61,368937,2
Bihar,Madhepura,VIJAY KUMAR SINGH,Bharatiya Janata Party,252466,68,252534,3
Bihar,Madhepura,SHARAD YADAV,Janata Dal (United),312711,17,312728,4
Bihar,Madhepura,ANWAR ALAM,Aam Aadmi Party,9537,1,9538,5
Bihar,Madhepura,CHANDRASHEKHAR YADAV,Bahujan Mukti Party,3768,0,3768,6
Bihar,Madhepura,BHIKHA PASWAN,BVM,6649,0,6649,7
Bihar,Madhepura,MOHAMMAD ARSHAD HUSSAIN,Peace Party,9585,0,9585,8
Bihar,Madhepura,SAJAN KUMAR JHA,Jai Maha Bharath Party,4396,0,4396,9
Bihar,Madhepura,PRASANNA KUMAR,Independent,5369,1,5370,10
Bihar,Madhepura,MINA DEVI,Independent,9039,0,9039,11
Bihar,Madhepura,RAJO SAH,Independent,12247,0,12247,12
Bihar,Madhepura,None of the Above,NOTA,21924,0,21924,13
Bihar,Darbhanga,MD. ALI ASHRAF FATMI,Rashtriya Janata Dal,279905,1,279906,1
Bihar,Darbhanga,KIRTI AZAD,Bharatiya Janata Party,314933,16,314949,2
Bihar,Darbhanga,DURGA NAND MAHAVIR NAYAK,Bahujan Samaj Party,8835,0,8835,3
Bihar,Darbhanga,SANJAY KUMAR JHA,Janata Dal (United),104494,0,104494,4
Bihar,Darbhanga,HADAY NA. YADAV,Communist Party of India  (Marxist),11606,0,11606,5
Bihar,Darbhanga,KEDAR KU. KESHAV,Shivsena,25277,0,25277,6
Bihar,Darbhanga,JAINATH,Bahujan Mukti Party,2956,0,2956,7
Bihar,Darbhanga,DR. PRABHAT RANJAN DAS,Aam Aadmi Party,7550,0,7550,8
Bihar,Darbhanga,FAISAL AHMAD,JDR,2900,0,2900,9
Bihar,Darbhanga,BRAHMADEO PRASAD KARYEE,BJKVP,2929,0,2929,10
Bihar,Darbhanga,COLONEL LAKSHMESHWAR MISHRA,Communist Party of India (Marxist-Lenninist) (Liberation),9111,0,9111,11
Bihar,Darbhanga,SADRE ALAM KHAN,AKBMP,4558,0,4558,12
Bihar,Darbhanga,KRISHNA KUMAR PASWAN,Independent,10080,0,10080,13
Bihar,Darbhanga,PRADEEP PASWAN,Independent,5963,0,5963,14
Bihar,Darbhanga,PRAVIN KUMAR JHA,Independent,16125,0,16125,15
Bihar,Darbhanga,None of the Above,NOTA,21103,0,21103,16
Bihar,Muzaffarpur,AKHILESH PD SINGH,Indian National Congress,246869,4,246873,1
Bihar,Muzaffarpur,AJAY NISHAD,Bharatiya Janata Party,469282,13,469295,2
Bihar,Muzaffarpur,RAJEEV RANJAN,Bahujan Samaj Party,9069,0,9069,3
Bihar,Muzaffarpur,VIJENDRA CHAUDHARY,Janata Dal (United),85135,5,85140,4
Bihar,Muzaffarpur,AKSHAY VERMA,SKLP,7569,0,7569,5
Bihar,Muzaffarpur,ASHOK KUMAR JHA,Shivsena,19945,0,19945,6
Bihar,Muzaffarpur,ASHOK KUMAR SINGH,SOCIALIST UNITY CENTRE OF INDIA (COMMUNIST),3734,0,3734,7
Bihar,Muzaffarpur,KUNAL PRIYADARSHI,Rashtriya Krantikari Samajwadi Party,2471,0,2471,8
Bihar,Muzaffarpur,DEVENDRA RAKESH,BJKVP,2299,0,2299,9
Bihar,Muzaffarpur,NAVAL KISHORE JHA,Samajwadi Janata Party (Rashtriya),2364,0,2364,10
Bihar,Muzaffarpur,NILU SINGH,PBI,2271,0,2271,11
Bihar,Muzaffarpur,PANKAJ KUMAR SRIVASTAVA,JPJD,3365,0,3365,12
Bihar,Muzaffarpur,PRABHAT SUMAN,Aam Aadmi Party,6945,0,6945,13
Bihar,Muzaffarpur,MADHUR SHEEL,Jai Maha Bharath Party,4309,0,4309,14
Bihar,Muzaffarpur,MAHESH RAI,Bahujan Mukti Party,7978,0,7978,15
Bihar,Muzaffarpur,RAGHVENDRA PRATAP SINGH,ravp,13283,0,13283,16
Bihar,Muzaffarpur,RAJESH KUMAR,All India Forward Bloc,6118,0,6118,17
Bihar,Muzaffarpur,SHATRUDHAN SAHNI,Communist Party of India (Marxist-Lenninist) (Liberation),8223,0,8223,18
Bihar,Muzaffarpur,AJITANSH GAUR,Independent,2755,0,2755,19
Bihar,Muzaffarpur,KAMLESH CHOUDHARY,Independent,3147,0,3147,20
Bihar,Muzaffarpur,DEEPAK KUMAR,Independent,1809,0,1809,21
Bihar,Muzaffarpur,NAGESHWAR PRASAD SINGH,Independent,9202,0,9202,22
Bihar,Muzaffarpur,MAHESH PASWAN,Independent,1749,0,1749,23
Bihar,Muzaffarpur,MOHAMMAD ANWARUL HAQUE,Independent,2354,0,2354,24
Bihar,Muzaffarpur,MOHMMAD TAIYAB,Independent,2269,0,2269,25
Bihar,Muzaffarpur,RAVI SHANKAR PASWAN,Independent,3334,0,3334,26
Bihar,Muzaffarpur,RUPESH KUMAR KUAR,Independent,2370,0,2370,27
Bihar,Muzaffarpur,SHRAVAN KUMAR JHA,Independent,3746,0,3746,28
Bihar,Muzaffarpur,SURESH KUMAR,Independent,5211,0,5211,29
Bihar,Muzaffarpur,None of the Above,NOTA,9690,0,9690,30
Bihar,Vaishali,RAGHUVANSH PRASAD SINGH,Rashtriya Janata Dal,206180,3,206183,1
Bihar,Vaishali,RAMA KISHORE SINGH,Lok Jan Shakti Party,305446,4,305450,2
Bihar,Vaishali,VIJAY KUMAR SAHNI,Janata Dal (United),145180,2,145182,3
Bihar,Vaishali,SHANKAR MAHTO,Bahujan Samaj Party,23676,1,23677,4
Bihar,Vaishali,INDRADEO ROY,SOCIALIST UNITY CENTRE OF INDIA (COMMUNIST),5218,0,5218,5
Bihar,Vaishali,JAYNARAYAN SAH,BJKVP,3191,0,3191,6
Bihar,Vaishali,MD. NAUSHAD,Vanchitsamaj Insaaf Party,3866,0,3866,7
Bihar,Vaishali,PARMESHWAR RAM,Bahujan Mukti Party,4000,0,4000,8
Bihar,Vaishali,MUKESH RAM,Rashtriya Krantikari Samajwadi Party,5497,0,5497,9
Bihar,Vaishali,RAAJ MANGAL PRASAD,Aam Aadmi Party,7768,0,7768,10
Bihar,Vaishali,VINOD PANDIT,LPSP,6430,0,6430,11
Bihar,Vaishali,MD.HASIB,Rashtriya Samanta Dal,11075,0,11075,12
Bihar,Vaishali,ANU SHUKLA,Independent,104228,1,104229,13
Bihar,Vaishali,JITENDRA PRASAD,Independent,12369,0,12369,14
Bihar,Vaishali,BALENDRA SINGH,Independent,15178,0,15178,15
Bihar,Vaishali,DR. MOHAMMAD NABI HASSAN,Independent,22455,0,22455,16
Bihar,Vaishali,MOHAMMAD UMAR ANSARI,Independent,8254,0,8254,17
Bihar,Vaishali,RANJEET KUMAR JHA,Independent,11540,0,11540,18
Bihar,Vaishali,RAM PUKAR RAI,Independent,7182,0,7182,19
Bihar,Vaishali,RAMESHWAR SAH,Independent,5483,0,5483,20
Bihar,Vaishali,LALJI KUMAR RAKESH,Independent,2667,0,2667,21
Bihar,Vaishali,SANDHYA DEVI,Independent,2983,0,2983,22
Bihar,Vaishali,None of the Above,NOTA,6060,0,6060,23
Bihar,Gopalganj (SC),ANIL KUMAR,Janata Dal (United),100417,2,100419,1
Bihar,Gopalganj (SC),CHANDRADIP RAM,Bahujan Samaj Party,16751,0,16751,2
Bihar,Gopalganj (SC),JANAK RAM,Bharatiya Janata Party,478758,15,478773,3
Bihar,Gopalganj (SC),DR. JYOTI BHARTI,Indian National Congress,191832,5,191837,4
Bihar,Gopalganj (SC),JALESHWAR NATH RAM,Bahujan Mukti Party,6264,0,6264,5
Bihar,Gopalganj (SC),JITENDRA MANJHI,Communist Party of India (Marxist-Lenninist) (Liberation),12423,0,12423,6
Bihar,Gopalganj (SC),RAMASHANKAR RAM,Rashtriya Jan-Jagran Morcha,7147,0,7147,7
Bihar,Gopalganj (SC),SUNITA KUMAR,Samajwadi Party,4586,0,4586,8
Bihar,Gopalganj (SC),SURENDRA PASWAN,Rashtriya Bahujan Congress Party,4717,0,4717,9
Bihar,Gopalganj (SC),SURENDRA RAM,BED,16680,0,16680,10
Bihar,Gopalganj (SC),DINANATH MANJHI,Independent,13983,0,13983,11
Bihar,Gopalganj (SC),MUDRIKA BAITHA,Independent,8491,0,8491,12
Bihar,Gopalganj (SC),RAM KUMAR MANJHI,Independent,14162,0,14162,13
Bihar,Gopalganj (SC),SATEYNDRA BAITHA,Independent,9509,0,9509,14
Bihar,Gopalganj (SC),None of the Above,NOTA,17841,0,17841,15
Bihar,Siwan,OM PRAKASH YADAV,Bharatiya Janata Party,372659,11,372670,1
Bihar,Siwan,GANESH RAM,Bahujan Samaj Party,14584,0,14584,2
Bihar,Siwan,MANOJ KUMAR SINGH,Janata Dal (United),79239,0,79239,3
Bihar,Siwan,HENA SHAHAB,Rashtriya Janata Dal,258818,5,258823,4
Bihar,Siwan,AMAR NATH YADAV,Communist Party of India (Marxist-Lenninist) (Liberation),81006,0,81006,5
Bihar,Siwan,KHALIL MIYA,Gondvana Gantantra Party,9580,0,9580,6
Bihar,Siwan,NAGENDRA TIWARI,LKJP,2611,0,2611,7
Bihar,Siwan,NARAD PNDIT,JPJD,3250,0,3250,8
Bihar,Siwan,PARAMANAND GOND,SWSP,4016,0,4016,9
Bihar,Siwan,PARMESHWAR  MANJHI,Bahujan Mukti Party,5683,0,5683,10
Bihar,Siwan,RANJAN KUMAR,BVM,8851,0,8851,11
Bihar,Siwan,RAM BINAY RAY,BED,11757,0,11757,12
Bihar,Siwan,SATYA PRAKASH PANDEY,Aam Aadmi Party,10542,0,10542,13
Bihar,Siwan,None of the Above,NOTA,21409,0,21409,14
Bihar,Maharajganj,"JANARDAN SINGH ""SIGRIWAL""",Bharatiya Janata Party,320645,108,320753,1
Bihar,Maharajganj,NAGENDRA PRASAD,Bahujan Samaj Party,11187,2,11189,2
Bihar,Maharajganj,PRABHU NATH SINGH,Rashtriya Janata Dal,282171,167,282338,3
Bihar,Maharajganj,MANORANJAN SINGH,Janata Dal (United),149436,47,149483,4
Bihar,Maharajganj,BYAS MANJHI,Bahujan Mukti Party,4796,0,4796,5
Bihar,Maharajganj,RINA RANI,Aam Aadmi Party,6429,1,6430,6
Bihar,Maharajganj,UMASHANKAR TIWARI,Independent,11598,1,11599,7
Bihar,Maharajganj,DR. GOPAL PRASAD,Independent,10601,1,10602,8
Bihar,Maharajganj,BRINDA PATHAK,Independent,17186,0,17186,9
Bihar,Maharajganj,SHIV NATH MAHTO,Independent,8874,0,8874,10
Bihar,Maharajganj,None of the Above,NOTA,23404,0,23404,11
Bihar,Saran,BAL MUKUND CHAUHAN,Bahujan Samaj Party,15484,16,15500,1
Bihar,Saran,RAJIV PRATAP RUDY,Bharatiya Janata Party,354738,382,355120,2
Bihar,Saran,RABRI DEVI,Rashtriya Janata Dal,313878,294,314172,3
Bihar,Saran,SALEEM PERWEZ,Janata Dal (United),106916,92,107008,4
Bihar,Saran,CHANDAN KUMAR ALIAS CHANDAN GUPTA,BJPARTY,6765,0,6765,5
Bihar,Saran,NIRAJ RAM,Bahujan Mukti Party,2818,0,2818,6
Bihar,Saran,PARMATMA SINGH,Aam Aadmi Party,5097,2,5099,7
Bihar,Saran,RANJAN KUMAR,Jai Maha Bharath Party,3217,0,3217,8
Bihar,Saran,RAJESH KUMAR,BED,9747,0,9747,9
Bihar,Saran,LALAN PRASAD,Independent,14688,0,14688,10
Bihar,Saran,LALU RAI,Independent,9956,1,9957,11
Bihar,Saran,None of the Above,NOTA,19161,2,19163,12
Bihar,Hajipur (SC),DHANESHWAR RAM,Bahujan Samaj Party,12682,6,12688,1
Bihar,Hajipur (SC),RAM SUNDAR DAS,Janata Dal (United),95701,89,95790,2
Bihar,Hajipur (SC),RAMVILAS PASWAN,Lok Jan Shakti Party,454874,778,455652,3
Bihar,Hajipur (SC),SANJEEV PRASAD TONI,Indian National Congress,229816,336,230152,4
Bihar,Hajipur (SC),UJJAWAL KANT HUNKAR,Bharatiya Momin Front,8957,0,8957,5
Bihar,Hajipur (SC),RANDHIR KUMAR RAM,BJKVP,3711,0,3711,6
Bihar,Hajipur (SC),RAJ KR. PASWAN,Aam Aadmi Party,6339,5,6344,7
Bihar,Hajipur (SC),RINA RAGNI,Bahujan Mukti Party,3880,2,3882,8
Bihar,Hajipur (SC),VIDHAN CHANDRA RANA,Samajwadi Janata Party (Rashtriya),3198,0,3198,9
Bihar,Hajipur (SC),VIRCHANDRA PASWAN,Samajwadi Party,4183,2,4185,10
Bihar,Hajipur (SC),SATYA NARAYAN PASWAN,All India Forward Bloc,3216,0,3216,11
Bihar,Hajipur (SC),UPENDER RAM,Independent,8896,0,8896,12
Bihar,Hajipur (SC),DINA NATH RAM,Independent,21045,0,21045,13
Bihar,Hajipur (SC),VIPHIYA DEVI,Independent,24399,0,24399,14
Bihar,Hajipur (SC),SURESH PASWAN,Independent,7544,0,7544,15
Bihar,Hajipur (SC),None of the Above,NOTA,15039,8,15047,16
Bihar,Ujiarpur,ASHWAMEDH DEVI,Janata Dal (United),119669,0,119669,1
Bihar,Ujiarpur,ALOK KUMAR MEHTA,Rashtriya Janata Dal,256881,2,256883,2
Bihar,Ujiarpur,DHARMENDRA SAHANI,Bahujan Samaj Party,15198,0,15198,3
Bihar,Ujiarpur,NITYANAND RAI,Bharatiya Janata Party,317339,13,317352,4
Bihar,Ujiarpur,RAM DEO VERMA,Communist Party of India  (Marxist),53044,0,53044,5
Bihar,Ujiarpur,AMRENDRA KUMAR YADAV,Rashtriya Krantikari Samajwadi Party,5631,0,5631,6
Bihar,Ujiarpur,KISHOR KUMAR,BLSP,5669,0,5669,7
Bihar,Ujiarpur,JITENDRA KUMAR RAI,Shivsena,11990,0,11990,8
Bihar,Ujiarpur,MD. TAHIR ARAMAN,NADP,2536,0,2536,9
Bihar,Ujiarpur,PRITHIVINATH PRASAD,MHD,2482,0,2482,10
Bihar,Ujiarpur,PREM LATA DEVI,JPJD,3152,0,3152,11
Bihar,Ujiarpur,PHOOL BABU SINGH,Communist Party of India (Marxist-Lenninist) (Liberation),6967,0,6967,12
Bihar,Ujiarpur,MADHURI,Bahujan Mukti Party,7661,0,7661,13
Bihar,Ujiarpur,MITHILESH KUMAR JHA,Jharkhand Mukti Morcha,7810,0,7810,14
Bihar,Ujiarpur,VINDESHWARI SAHNI,Pratap Shiv Sena,7969,0,7969,15
Bihar,Ujiarpur,SHIVANI UMANI,JDR,12520,0,12520,16
Bihar,Ujiarpur,SURESH CHAUDHARI,Aam Aadmi Party,8917,0,8917,17
Bihar,Ujiarpur,ARJUN KUMAR SAH,Independent,4201,0,4201,18
Bihar,Ujiarpur,MINTU PASWAN,Independent,3098,0,3098,19
Bihar,Ujiarpur,None of the Above,NOTA,6171,0,6171,20
Bihar,Samastipur (SC),DR. ASHOK KUMAR,Indian National Congress,263528,1,263529,1
Bihar,Samastipur (SC),MAHESHWAR HAZARI,Janata Dal (United),200120,4,200124,2
Bihar,Samastipur (SC),RAM CHANDRA RAM,Bahujan Samaj Party,12813,0,12813,3
Bihar,Samastipur (SC),RAM CHANDRA PASWAN,Lok Jan Shakti Party,270391,10,270401,4
Bihar,Samastipur (SC),AMIT KUMAR,Samajwadi Janata Party (Rashtriya),7423,0,7423,5
Bihar,Samastipur (SC),ASHOK PASWAN,Bahujan Mukti Party,6603,0,6603,6
Bihar,Samastipur (SC),GANESH KUMAR,Aam Aadmi Party,9954,0,9954,7
Bihar,Samastipur (SC),LAL BAHADUR SADA,Communist Party of India (Marxist-Lenninist) (Liberation),9665,0,9665,8
Bihar,Samastipur (SC),BALESHWAR PASWAN,JDR,15836,1,15837,9
Bihar,Samastipur (SC),VIJAY KUMAR RAM,ravp,11813,0,11813,10
Bihar,Samastipur (SC),SHATRUDHAN KUMAR PASWAN,Rashtriya Krantikari Samajwadi Party,12322,0,12322,11
Bihar,Samastipur (SC),MITHILESH KUMAR RAJAK,Independent,13504,0,13504,12
Bihar,Samastipur (SC),None of the Above,NOTA,29211,0,29211,13
Bihar,Begusarai,MD. TANVEER HASSAN,Rashtriya Janata Dal,369699,193,369892,1
Bihar,Begusarai,BHOLA SINGH,Bharatiya Janata Party,427987,240,428227,2
Bihar,Begusarai,RAJENDRA PRASAD SINGH,Communist Party of India,192592,47,192639,3
Bihar,Begusarai,RAM PADARATH YADAV,Bahujan Samaj Party,9013,1,9014,4
Bihar,Begusarai,PINKI DEVI,Bahujan Mukti Party,4858,0,4858,5
Bihar,Begusarai,SUNIL KUMAR,Aam Aadmi Party,8633,6,8639,6
Bihar,Begusarai,HARI KANT PRASAD,BBC,3344,0,3344,7
Bihar,Begusarai,PANKAJ PASWAN,Independent,3323,0,3323,8
Bihar,Begusarai,MOHAMMAD JAVED,Independent,3405,0,3405,9
Bihar,Begusarai,RAJENDRA YADAV,Independent,4605,0,4605,10
Bihar,Begusarai,VAIJ NATH PASWAN,Independent,12143,0,12143,11
Bihar,Begusarai,SUSHIL KUMAR,Independent,11144,0,11144,12
Bihar,Begusarai,None of the Above,NOTA,26619,3,26622,13
Bihar,Khagaria,KRISHNA KUMARI YADAV,Rashtriya Janata Dal,237772,31,237803,1
Bihar,Khagaria,CHOUDHARY MAHBOOB ALI KAISER,Lok Jan Shakti Party,313736,70,313806,2
Bihar,Khagaria,JAGDISH CHANDRA VASU,Communist Party of India  (Marxist),24489,1,24490,3
Bihar,Khagaria,DINESH CHANDRA YADAV,Janata Dal (United),220289,27,220316,4
Bihar,Khagaria,RAJESH KUMAR,Bahujan Samaj Party,6480,0,6480,5
Bihar,Khagaria,GANESH MUKHIYA NISHAD,SKLP,4522,0,4522,6
Bihar,Khagaria,TEJ BAHADUR SINGH,Pratap Shiv Sena,4053,0,4053,7
Bihar,Khagaria,BRAHAMDEO MUKHIA,Rashtriya Naujawan Dal,5215,0,5215,8
Bihar,Khagaria,MAKKHAN SAH,Samajwadi Janata Party (Rashtriya),6651,0,6651,9
Bihar,Khagaria,RAJEEV RANJAN,Lok Dal,5722,0,5722,10
Bihar,Khagaria,DR. SWAMI VIVEKANAND,Aam Aadmi Party,14490,1,14491,11
Bihar,Khagaria,UMESH CHANDRA BHARTI,Independent,14926,0,14926,12
Bihar,Khagaria,SATISH PRASAD SINGH,Independent,13888,0,13888,13
Bihar,Khagaria,None of the Above,NOTA,23868,0,23868,14
Bihar,Bhagalpur,ABU QAISER,Janata Dal (United),132256,0,132256,1
Bihar,Bhagalpur,NAUSHABA KHANAM,Bahujan Samaj Party,11265,0,11265,2
Bihar,Bhagalpur,SHAILESH KUMAR URPH BULO MANDAL,Rashtriya Janata Dal,367619,4,367623,3
Bihar,Bhagalpur,SYED SHAHNAWAZ HUSSAIN,Bharatiya Janata Party,358083,55,358138,4
Bihar,Bhagalpur,KUMKUM SINGH,BVM,8025,0,8025,5
Bihar,Bhagalpur,GAURAV KUMAR GHOSH,NTP,3251,0,3251,6
Bihar,Bhagalpur,NISHI KANT MANDAL,Bahujan Mukti Party,3147,0,3147,7
Bihar,Bhagalpur,PUROSOTTAM CHOUBEY,Samajwadi Party,2416,0,2416,8
Bihar,Bhagalpur,PROF. YOGENDRA MAHTO,Aam Aadmi Party,5827,3,5830,9
Bihar,Bhagalpur,RINKI KUMARI,Communist Party of India (Marxist-Lenninist) (Liberation),5778,0,5778,10
Bihar,Bhagalpur,VIREN DAS,SaBP,3005,0,3005,11
Bihar,Bhagalpur,ANAND KUMAR JAIN,Independent,4734,0,4734,12
Bihar,Bhagalpur,INDRADEO KUMAR SINGH,Independent,12710,0,12710,13
Bihar,Bhagalpur,MAHADEO KUMAR,Independent,9295,0,9295,14
Bihar,Bhagalpur,RANJAN KUMAR,Independent,5165,0,5165,15
Bihar,Bhagalpur,RAMJEE MANDAL,Independent,18937,0,18937,16
Bihar,Bhagalpur,SIKANDAR TANTI,Independent,7122,0,7122,17
Bihar,Bhagalpur,SUMAN KUMAR,Independent,3444,0,3444,18
Bihar,Bhagalpur,None of the Above,NOTA,11874,1,11875,19
Bihar,Banka,JAI PRAKASH NARAYAN YADAV,Rashtriya Janata Dal,285148,2,285150,1
Bihar,Banka,PUTUL KUMARI,Bharatiya Janata Party,274980,26,275006,2
Bihar,Banka,SANJAY KUMAR -I,Communist Party of India,220703,5,220708,3
Bihar,Banka,SANJAY KUMAR-II,Bahujan Samaj Party,10558,0,10558,4
Bihar,Banka,UMAKANT YADAV,Bahujan Mukti Party,2266,0,2266,5
Bihar,Banka,DEEPAK KUMAR,SOCIALIST UNITY CENTRE OF INDIA (COMMUNIST),2481,0,2481,6
Bihar,Banka,NIRAJ KUMAR,Aam Aadmi Party,6057,1,6058,7
Bihar,Banka,MAHBOOB ALAM ANSARI,Bharatiya Momin Front,2280,0,2280,8
Bihar,Banka,MITHLESH KUMAR SINGH,National Loktantrik Party,2977,0,2977,9
Bihar,Banka,MUKESH KUMAR SINHA,BEMP,2405,0,2405,10
Bihar,Banka,VIJAY BHARTI,ravp,4317,0,4317,11
Bihar,Banka,SUBODH NARAYAN JHA,All India Trinamool Congress,4411,1,4412,12
Bihar,Banka,AKHIL BHARTIYA SHARMA,Independent,4721,0,4721,13
Bihar,Banka,ALIMUDDIN ANSARI,Independent,12871,0,12871,14
Bihar,Banka,INDRARAJ SINGH SAINI,Independent,11520,0,11520,15
Bihar,Banka,NARESH KUMAR PRIYADARSHI,Independent,30814,0,30814,16
Bihar,Banka,SARGUN SAH,Independent,11056,0,11056,17
Bihar,Banka,None of the Above,NOTA,9753,0,9753,18
Bihar,Munger,KAMLESHWARI MANDAL,Bahujan Samaj Party,11225,0,11225,1
Bihar,Munger,PRAGATI MEHTA,Rashtriya Janata Dal,182956,15,182971,2
Bihar,Munger,RAJIV RANJAN SINGH ALIAS LALAN SINGH,Janata Dal (United),243818,9,243827,3
Bihar,Munger,VEENA DEVI,Lok Jan Shakti Party,352863,48,352911,4
Bihar,Munger,ASHOK KUMAR SINGH,Shivsena,50464,5,50469,5
Bihar,Munger,PRAMOD KUMAR,SOCIALIST UNITY CENTRE OF INDIA (COMMUNIST),4710,0,4710,6
Bihar,Munger,RAM BADAN RAI,Samajwadi Party,6769,0,6769,7
Bihar,Munger,SHANKAR PRASAD,Bahujan Mukti Party,3956,0,3956,8
Bihar,Munger,SANDEEP,Aam Aadmi Party,7476,5,7481,9
Bihar,Munger,SURYODAY PASWAN,SaBP,5113,0,5113,10
Bihar,Munger,UCHIT KUMAR,Independent,11122,0,11122,11
Bihar,Munger,MUZAFFAR FAKHRUDDIN,Independent,10264,0,10264,12
Bihar,Munger,SHARWAN KUMAR ANAND,Independent,8112,0,8112,13
Bihar,Munger,None of the Above,NOTA,15420,0,15420,14
Bihar,Nalanda,ASHISH RANJAN SINHA,Indian National Congress,127258,12,127270,1
Bihar,Nalanda,KAUSHLENDRA KUMAR,Janata Dal (United),321938,44,321982,2
Bihar,Nalanda,SANJAY KUMAR,Bahujan Samaj Party,23593,2,23595,3
Bihar,Nalanda,SATYA NAND SHARMA,Lok Jan Shakti Party,312315,40,312355,4
Bihar,Nalanda,DHIRENDRA KUMAR,Jan Parishad,8757,0,8757,5
Bihar,Nalanda,NAYEB ALI,All India Trinamool Congress,4613,0,4613,6
Bihar,Nalanda,NIRAJ SHARMA,ravp,2342,0,2342,7
Bihar,Nalanda,PARNAV PRAKASH,Aam Aadmi Party,18212,12,18224,8
Bihar,Nalanda,PRAMOD KUMAR NIRALA,SaBP,2779,0,2779,9
Bihar,Nalanda,BHOLA SAO,KVD,2213,0,2213,10
Bihar,Nalanda,MAHESH PASWAN,BBMP,4236,0,4236,11
Bihar,Nalanda,YOGENDRA PRASAD,BIP,4599,1,4600,12
Bihar,Nalanda,RAKESH RANJAN SINHA,Republican Party of India (A),13381,0,13381,13
Bihar,Nalanda,LALLU RAM,Bahujan Mukti Party,6788,0,6788,14
Bihar,Nalanda,SHASHI YADAV,Communist Party of India (Marxist-Lenninist) (Liberation),19477,0,19477,15
Bihar,Nalanda,SHAILESH KUMAR,APCP,15370,0,15370,16
Bihar,Nalanda,AWADH KUMAR,Independent,6346,0,6346,17
Bihar,Nalanda,KAUSHAL KUMAR KAUSHALENDRA SINHA ALIAS BHARAT MANAS,Independent,7472,0,7472,18
Bihar,Nalanda,NARESH PRASAD SINGH,Independent,3620,0,3620,19
Bihar,Nalanda,MUNNA PRASAD,Independent,6048,0,6048,20
Bihar,Nalanda,LATA SINHA,Independent,2237,0,2237,21
Bihar,Nalanda,VISHWAJIT KUMAR,Independent,2604,0,2604,22
Bihar,Nalanda,None of the Above,NOTA,5450,2,5452,23
Bihar,Patna Sahib,KUNAL SINGH,Indian National Congress,219693,407,220100,1
Bihar,Patna Sahib,GANESH SAW,Bahujan Samaj Party,9660,31,9691,2
Bihar,Patna Sahib,DR.GOPAL PRASAD SINHA,Janata Dal (United),90709,315,91024,3
Bihar,Patna Sahib,SHATRUGHANA SINHA,Bharatiya Janata Party,484458,1447,485905,4
Bihar,Patna Sahib,UMESH KUMAR,Samajwadi Party,10820,16,10836,5
Bihar,Patna Sahib,GAJENDRA KUMAR,SaBP,2164,2,2166,6
Bihar,Patna Sahib,CHANDRA BHUSHAN PRASAD CHANDRAVANSHI,Bahujan Mukti Party,3005,10,3015,7
Bihar,Patna Sahib,JAUHAR AZAD,JDR,1831,3,1834,8
Bihar,Patna Sahib,PARVEEN AMANULLAH,Aam Aadmi Party,16242,139,16381,9
Bihar,Patna Sahib,PARWEZ AHMAD,LKJP,1854,2,1856,10
Bihar,Patna Sahib,DR. RAKESH DUTTA MISHRA,BJKD,2681,6,2687,11
Bihar,Patna Sahib,LAL BAHADUR SINGH PATEL,KVD,2500,2,2502,12
Bihar,Patna Sahib,SHREEKANT LABH,Samajwadi Janata Party (Rashtriya),3177,1,3178,13
Bihar,Patna Sahib,ANIL KUMAR,Independent,2474,4,2478,14
Bihar,Patna Sahib,KUMAR RAJIV,Independent,2913,1,2914,15
Bihar,Patna Sahib,GANGA VISHNU PRASAD,Independent,8834,0,8834,16
Bihar,Patna Sahib,NAND KISHORE SINGH,Independent,6057,0,6057,17
Bihar,Patna Sahib,VIJAY KUMAR SAHNI,Independent,1242,1,1243,18
Bihar,Patna Sahib,SHYAM NANDAN PRASAD,Independent,1834,0,1834,19
Bihar,Patna Sahib,None of the Above,NOTA,7686,41,7727,20
Bihar,Pataliputra,MISHA BHARTI,Rashtriya Janata Dal,342478,462,342940,1
Bihar,Pataliputra,RANJAN PRASAD YADAV,Janata Dal (United),97006,222,97228,2
Bihar,Pataliputra,RAJ KUMAR RAM,Bahujan Samaj Party,17170,18,17188,3
Bihar,Pataliputra,RAM KRIPAL YADAV,Bharatiya Janata Party,382232,1030,383262,4
Bihar,Pataliputra,ABINASH KUMAR,BJKD,5852,2,5854,5
Bihar,Pataliputra,KUNDAN PRASAD SINGH,Aam Aadmi Party,5611,26,5637,6
Bihar,Pataliputra,CHANDRA DEV PRASAD,Bahujan Mukti Party,2266,2,2268,7
Bihar,Pataliputra,DEO KUMAR VERMA,Republican Party of India (A),2484,0,2484,8
Bihar,Pataliputra,NAGENDRA KUMAR,BVM,4301,1,4302,9
Bihar,Pataliputra,MUKUL KUMAR SHARMA,SaBP,3015,0,3015,10
Bihar,Pataliputra,RAMESHWAR PRASAD,Communist Party of India (Marxist-Lenninist) (Liberation),51590,33,51623,11
Bihar,Pataliputra,SHATRUDHAN SAW,BED,8174,10,8184,12
Bihar,Pataliputra,SUNIL KUMAR,Samajwadi Janata Party (Rashtriya),6268,1,6269,13
Bihar,Pataliputra,KUMAR INDRA BHUSHAN,Independent,5404,8,5412,14
Bihar,Pataliputra,JAI PRAKASH YADAV,Independent,4804,0,4804,15
Bihar,Pataliputra,DURGESH NANDAN SINGH ALIAS DURGESH NANDAN,Independent,16645,0,16645,16
Bihar,Pataliputra,NIRAJ KUMAR,Independent,8083,1,8084,17
Bihar,Pataliputra,PANCHAM LAL,Independent,2520,0,2520,18
Bihar,Pataliputra,MINENDRA KUMAR SINGH,Independent,1697,0,1697,19
Bihar,Pataliputra,SUNIL KUMAR SINGH,Independent,4555,0,4555,20
Bihar,Pataliputra,None of the Above,NOTA,4660,18,4678,21
Bihar,Arrah,MEENA SINGH,Janata Dal (United),75958,4,75962,1
Bihar,Arrah,RAMESH CHANDRA BADAL,Bahujan Samaj Party,7636,1,7637,2
Bihar,Arrah,RAJ KUMAR SINGH,Bharatiya Janata Party,390953,121,391074,3
Bihar,Arrah,SRIBHAGWAN SINGH KUSHWAHA,Rashtriya Janata Dal,255180,24,255204,4
Bihar,Arrah,BAIJNATH YADAV,Bahujan Mukti Party,6886,0,6886,5
Bihar,Arrah,BHARAT BHUSHAN PANDEY,Akhil Bharatiya Jan Sangh,10948,2,10950,6
Bihar,Arrah,RAJU YADAV,Communist Party of India (Marxist-Lenninist) (Liberation),98804,1,98805,7
Bihar,Arrah,SHAMBHU PRASAD SHARMA,HVD,5680,0,5680,8
Bihar,Arrah,DR. SURENDRA KUMAR PRASAD,Aam Aadmi Party,7512,6,7518,9
Bihar,Arrah,ASHOK RAM,Independent,7305,0,7305,10
Bihar,Arrah,GOPAL SINGH,Independent,5879,0,5879,11
Bihar,Arrah,SHANKAR DAYAL PASWAN,Independent,5610,0,5610,12
Bihar,Arrah,None of the Above,NOTA,14703,0,14703,13
Bihar,Buxar,ASHWINI KUMAR CHOUBEY,Bharatiya Janata Party,318954,58,319012,1
Bihar,Buxar,JAGADANAND SINGH,Rashtriya Janata Dal,186667,7,186674,2
Bihar,Buxar,DADAN YADAV,Bahujan Samaj Party,184786,2,184788,3
Bihar,Buxar,SHYAM LAL SINGH KUSHWAHA,Janata Dal (United),117012,0,117012,4
Bihar,Buxar,INDU SINGH,Communist Party of India (Marxist-Lenninist) (Liberation),13051,0,13051,5
Bihar,Buxar,TAFIR HUSSIAN,HVD,2241,0,2241,6
Bihar,Buxar,PARSHURAM PRASAD,Bahujan Mukti Party,2066,0,2066,7
Bihar,Buxar,PRADEEP KUMAR PRASAD,Pragatisheel Manav Samaj Party,6901,0,6901,8
Bihar,Buxar,MOKARRAM HUSSAIN,Suheldev Bhartiya Samaj Party,7514,0,7514,9
Bihar,Buxar,MONIBUR RAHMAN,JDR,1864,0,1864,10
Bihar,Buxar,RAJENDRA KUMAR SINGH CHOUHAN,BVM,2740,0,2740,11
Bihar,Buxar,SHIO KUMAR SHARMA,Jan Parishad,3437,0,3437,12
Bihar,Buxar,SWETA PATHAK,Aam Aadmi Party,7874,5,7879,13
Bihar,Buxar,NARENDRA PRATAP SINGH,Independent,6130,0,6130,14
Bihar,Buxar,LALLAN RUPNARAIN PATHAK,Independent,5294,0,5294,15
Bihar,Buxar,SHEO GOPAL CHOUDHARY,Independent,12422,0,12422,16
Bihar,Buxar,None of the Above,NOTA,9179,0,9179,17
Bihar,Sasaram (SC),KARRA PARASU RAMAIAH,Janata Dal (United),93138,172,93310,1
Bihar,Sasaram (SC),CHHEDI PASWAN,Bharatiya Janata Party,365576,511,366087,2
Bihar,Sasaram (SC),BALESHWAR BHARTI,Bahujan Samaj Party,31510,18,31528,3
Bihar,Sasaram (SC),MEIRA KUMAR,Indian National Congress,302385,375,302760,4
Bihar,Sasaram (SC),GEETA ARYA,Aam Aadmi Party,10997,8,11005,5
Bihar,Sasaram (SC),TETRI DEVI,Communist Party of India (Marxist-Lenninist) (Liberation),7479,7,7486,6
Bihar,Sasaram (SC),SAROJ RAM,Bahujan Mukti Party,3901,5,3906,7
Bihar,Sasaram (SC),NAND LAL RAM,Independent,2806,2,2808,8
Bihar,Sasaram (SC),RAVIKANT CHAUDHARY,Independent,3980,0,3980,9
Bihar,Sasaram (SC),RAJNARAIN RAO,Independent,4395,0,4395,10
Bihar,Sasaram (SC),SURENDRA RAM,Independent,6144,0,6144,11
Bihar,Sasaram (SC),None of the Above,NOTA,13377,2,13379,12
Bihar,Karakat,KANTI SINGH,Rashtriya Janata Dal,233619,32,233651,1
Bihar,Karakat,MAHABALI SINGH,Janata Dal (United),76699,10,76709,2
Bihar,Karakat,SANJAY KEWAT,Bahujan Samaj Party,45501,2,45503,3
Bihar,Karakat,UPENDRA KUSHWAHA,BLSP,338821,71,338892,4
Bihar,Karakat,GHULAM KUNDANAM,Aam Aadmi Party,6934,4,6938,5
Bihar,Karakat,DINESH KUMAR,Bahujan Mukti Party,2358,1,2359,6
Bihar,Karakat,PRADEEP KUMAR JOSHI,Rashtra Sewa Dal,6993,1,6994,7
Bihar,Karakat,RAJANI DUBEY,Akhil Bharatiya Jan Sangh,4794,1,4795,8
Bihar,Karakat,RAJA RAM SINGH,Communist Party of India (Marxist-Lenninist) (Liberation),32682,4,32686,9
Bihar,Karakat,VEENA BHARTI,Jan Parishad,4002,0,4002,10
Bihar,Karakat,IMRAN ALI,Independent,2048,0,2048,11
Bihar,Karakat,MD. DILBAS ANSARI,Independent,2813,0,2813,12
Bihar,Karakat,BHAIRAW DAYAL SINGH,Independent,6974,0,6974,13
Bihar,Karakat,RAM DAYAL SINGH,Independent,5459,0,5459,14
Bihar,Karakat,SATYA NARAYAN SINGH,Independent,9918,1,9919,15
Bihar,Karakat,None of the Above,NOTA,10185,0,10185,16
Bihar,Jahanabad,ANIL KUMAR SHARMA,Janata Dal (United),100811,40,100851,1
Bihar,Jahanabad,RAVINDRA SINGH,Bahujan Samaj Party,10578,2,10580,2
Bihar,Jahanabad,SURENDRA PRASAD YADAV,Rashtriya Janata Dal,280086,221,280307,3
Bihar,Jahanabad,DR. ARUN KUMAR,BLSP,322422,225,322647,4
Bihar,Jahanabad,MD. ISTIYAK,All India Trinamool Congress,6040,1,6041,5
Bihar,Jahanabad,CHANDRA BHUSHAN SHARMA,Aam Aadmi Party,3706,5,3711,6
Bihar,Jahanabad,NARENDRA KUMAR,Shivsena,2121,15,2136,7
Bihar,Jahanabad,PARSHURAM VIND,Bahujan Mukti Party,2720,1,2721,8
Bihar,Jahanabad,MANJU DEVI,KVD,2825,1,2826,9
Bihar,Jahanabad,RAMADHAR SINGH,Communist Party of India (Marxist-Lenninist) (Liberation),34365,0,34365,10
Bihar,Jahanabad,RAHUL RANJAN,Jharkhand Mukti Morcha,3521,0,3521,11
Bihar,Jahanabad,ARJUN THAKUR,Independent,7755,2,7757,12
Bihar,Jahanabad,NITYANAND SINGH,Independent,10625,0,10625,13
Bihar,Jahanabad,MANJAY KUMAR,Independent,8874,0,8874,14
Bihar,Jahanabad,SUDAY YADAV,Independent,4202,0,4202,15
Bihar,Jahanabad,None of the Above,NOTA,10352,0,10352,16
Bihar,Aurangabad,NIKHIL KUMAR,Indian National Congress,241433,161,241594,1
Bihar,Aurangabad,BAGI KUMAR VERMA,Janata Dal (United),136045,92,136137,2
Bihar,Aurangabad,SANTOSH KUMAR,Bahujan Samaj Party,27818,15,27833,3
Bihar,Aurangabad,SUSHIL KUMAR SINGH,Bharatiya Janata Party,307605,336,307941,4
Bihar,Aurangabad,UPENDRA NATH,Bahujan Mukti Party,9253,2,9255,5
Bihar,Aurangabad,USHA SHARAN,Sanyukt Samajwadi Dal,4608,0,4608,6
Bihar,Aurangabad,RAGINI LATA SINGH,Aam Aadmi Party,6699,4,6703,7
Bihar,Aurangabad,RITA DEVI,Samajwadi Party,3332,1,3333,8
Bihar,Aurangabad,DURGA THAKUR,Independent,3696,0,3696,9
Bihar,Aurangabad,RAKESH SHARMA,Independent,5726,0,5726,10
Bihar,Aurangabad,RAMJI SINGH,Independent,7195,0,7195,11
Bihar,Aurangabad,BIJEET KUMAR,Independent,6121,0,6121,12
Bihar,Aurangabad,SOMARU PASWAN,Independent,8678,0,8678,13
Bihar,Aurangabad,None of the Above,NOTA,17454,0,17454,14
Bihar,Gaya (SC),JITAN RAM MANJHI,Janata Dal (United),131403,425,131828,1
Bihar,Gaya (SC),RAMJI MANJHI,Rashtriya Janata Dal,210042,684,210726,2
Bihar,Gaya (SC),SHIV KUMAR KANT,Bahujan Samaj Party,15982,46,16028,3
Bihar,Gaya (SC),HARI MANJHI,Bharatiya Janata Party,325040,1190,326230,4
Bihar,Gaya (SC),ASHOK KUMAR,Jharkhand Mukti Morcha,36860,3,36863,5
Bihar,Gaya (SC),INDRA DEO CHOUDHARY,Bahujan Mukti Party,5531,13,5544,6
Bihar,Gaya (SC),KAPIL CHOUDHARY,All India Trinamool Congress,8996,8,9004,7
Bihar,Gaya (SC),DHANANJAY KISHORE,Aam Aadmi Party,7296,16,7312,8
Bihar,Gaya (SC),NIRANJAN KUMAR,Communist Party of India (Marxist-Lenninist) (Liberation),7609,15,7624,9
Bihar,Gaya (SC),BHUNESWAR DAS,RAHM,7544,5,7549,10
Bihar,Gaya (SC),MAMTA KUMARI,Samajwadi Party,6064,1,6065,11
Bihar,Gaya (SC),SHIV SHANKAR KUMAR,BBMP,5920,4,5924,12
Bihar,Gaya (SC),DR. DEV KUMAR CHOUDHARY,Independent,19619,32,19651,13
Bihar,Gaya (SC),None of the Above,NOTA,19016,14,19030,14
Bihar,Nawada,KAUSHAL YADAV,Janata Dal (United),168209,8,168217,1
Bihar,Nawada,GIRIRAJ SINGH,Bharatiya Janata Party,390205,43,390248,2
Bihar,Nawada,RAJ BALLABH PRASAD,Rashtriya Janata Dal,250086,5,250091,3
Bihar,Nawada,SOHAIL ANWER,Bahujan Samaj Party,7997,0,7997,4
Bihar,Nawada,ASHOK KUMAR,ravp,2596,0,2596,5
Bihar,Nawada,UMAKANT RAHI,Sanyukt Samajwadi Dal,2169,0,2169,6
Bihar,Nawada,PRAMENDRA KUMAR YADAV,BED,1650,0,1650,7
Bihar,Nawada,MOHAMMAD JAHID HUSAIN,All India Trinamool Congress,3138,0,3138,8
Bihar,Nawada,RAJENDRA SINGH,Aam Aadmi Party,4055,2,4057,9
Bihar,Nawada,VIJAY RAM,MOSP,3291,0,3291,10
Bihar,Nawada,SURENDRA RAJBANSHI,Samajwadi Party,3612,0,3612,11
Bihar,Nawada,AZAD GEETA PRASAD SHARMA,Independent,3568,0,3568,12
Bihar,Nawada,ADITYA NARAYAN,Independent,3743,0,3743,13
Bihar,Nawada,MANISH KUMAR,Independent,6443,0,6443,14
Bihar,Nawada,SATISH KUMAR,Independent,6736,0,6736,15
Bihar,Nawada,SAFDAR ISMAIL,Independent,12072,0,12072,16
Bihar,Nawada,SHULOCHANA DEVI,Independent,7324,0,7324,17
Bihar,Nawada,None of the Above,NOTA,7489,0,7489,18
Bihar,Jamui (SC),UDAY NARAIN CHOUDHARY,Janata Dal (United),198591,8,198599,1
Bihar,Jamui (SC),CHIRAG KUMAR PASWAN,Lok Jan Shakti Party,285334,20,285354,2
Bihar,Jamui (SC),BRAHMDEV ANAND PASWAN,Bahujan Samaj Party,15007,1,15008,3
Bihar,Jamui (SC),SUDHANSU SHEKHAR BHASKAR,Rashtriya Janata Dal,199401,6,199407,4
Bihar,Jamui (SC),UPENDRA RAVIDAS,Jharkhand Mukti Morcha,10748,0,10748,5
Bihar,Jamui (SC),JAY PRAKASH DAS,Communist Party of India (Marxist-Lenninist) (Liberation),6252,1,6253,6
Bihar,Jamui (SC),VINOD KUMAR DAS,Aam Aadmi Party,7157,2,7159,7
Bihar,Jamui (SC),VISHUN CHOUDHARY,Shivsena,7144,3,7147,8
Bihar,Jamui (SC),DILIP KUMAR,Independent,7634,1,7635,9
Bihar,Jamui (SC),MANOJ KUMAR MANJHI,Independent,8360,0,8360,10
Bihar,Jamui (SC),SUBHASH PASWAN,Independent,10452,0,10452,11
Bihar,Jamui (SC),None of the Above,NOTA,19517,0,19517,12
Goa,North Goa,RAVI NAIK,Indian National Congress,131904,400,132304,1
Goa,North Goa,SHRIPAD YESSO NAIK,Bharatiya Janata Party,236926,977,237903,2
Goa,North Goa,ADV. SUHAS NAIK,Communist Party of India,5638,2,5640,3
Goa,North Goa,DR.DATTARAM DESAI,Aam Aadmi Party,15830,27,15857,4
Goa,North Goa,RAJU DSOUZA,Samajwadi Janata Party (Rashtriya),3216,0,3216,5
Goa,North Goa,DAYANAND G. NARVEKAR,Independent,4117,11,4128,6
Goa,North Goa,MITTU MUJAVAR,Independent,1813,0,1813,7
Goa,North Goa,None of the Above,NOTA,5746,24,5770,8
Goa,South Goa,ALEIXO REGINALDO LOURENCO,Indian National Congress,166226,220,166446,1
Goa,South Goa,ADV. NARENDRA KESHAV SAWAIKAR,Bharatiya Janata Party,198176,600,198776,2
Goa,South Goa,ADV. RAJU MANGESHKAR,Communist Party of India,4435,2,4437,3
Goa,South Goa,CLIFFTON DE SOUZA,Bahujan Mukti Party,665,1,666,4
Goa,South Goa,CHURCHILL ALEMAO,All India Trinamool Congress,11932,9,11941,5
Goa,South Goa,ADV.  JAWAHAR DIAS,GOA,530,0,530,6
Goa,South Goa,SAVIO OLIVER RODRIGUES,GSRP,783,0,783,7
Goa,South Goa,SWATI S. KERKAR,Aam Aadmi Party,11227,19,11246,8
Goa,South Goa,GOVIND SHEPU GAUDE,Independent,7105,47,7152,9
Goa,South Goa,BALKRISHNA SALGAONKAR,Independent,682,1,683,10
Goa,South Goa,VENUS HABIB,Independent,790,0,790,11
Goa,South Goa,SHALOM MATHEW FRANCISCO SARDINHA,Independent,2586,0,2586,12
Goa,South Goa,None of the Above,NOTA,4320,13,4333,13
Gujarat,Kachchh,KAMALBHAI MATANG,Bahujan Samaj Party,21133,97,21230,1
Gujarat,Kachchh,CHAVDA VINOD LAKHAMASHI,Bharatiya Janata Party,560475,2380,562855,2
Gujarat,Kachchh,DR.DINESH PARMAR,Indian National Congress,307072,1301,308373,3
Gujarat,Kachchh,DANICHA GOVINDBHAI PUNAMCHAND,Aam Aadmi Party,15689,108,15797,4
Gujarat,Kachchh,HIRJI PUNJABHAI SIJU,Bahujan Mukti Party,21034,72,21106,5
Gujarat,Kachchh,None of the Above,NOTA,16780,99,16879,6
Gujarat,Banaskantha,CHAUDHARY HARIBHAI PARTHIBHAI,Bharatiya Janata Party,506171,1685,507856,1
Gujarat,Banaskantha,PATEL JOITABHAI KASNABHAI,Indian National Congress,304035,1487,305522,2
Gujarat,Banaskantha,MAHANT PARSOTAMGIRI TURANTGIRI,Bahujan Samaj Party,11160,15,11175,3
Gujarat,Banaskantha,CHOUDHARY ADAMBHAI NASIRBHAI,Samajwadi Party,2000,7,2007,4
Gujarat,Banaskantha,SANJAYKUMAR SOMNATHBHAI RAVAL,Aam Aadmi Party,6495,76,6571,5
Gujarat,Banaskantha,GAMAR VADHABHAI RADHABHAI,Independent,823,2,825,6
Gujarat,Banaskantha,THAKOR BHUPATAJI RAVAJI,Independent,1757,13,1770,7
Gujarat,Banaskantha,DABHI NAVAJIBHAI MADHABHAI,Independent,2107,11,2118,8
Gujarat,Banaskantha,BABAJI THAKOR,Independent,10861,36,10897,9
Gujarat,Banaskantha,MAHENDRABHAI KESARABHAI BUMBADIA,Independent,3260,42,3302,10
Gujarat,Banaskantha,MADHU NIRUPABEN NATVARLAL,Independent,2056,8,2064,11
Gujarat,Banaskantha,SHRIMALI ASHOKBHAI BALCHNDBHAI,Independent,2523,12,2535,12
Gujarat,Banaskantha,SOLANKI DINESHKUMAR ALJIBHAI,Independent,5386,2,5388,13
Gujarat,Banaskantha,SOLANKI SAYBABHAI NANABHAI,Independent,7204,3,7207,14
Gujarat,Banaskantha,None of the Above,NOTA,17378,19,17397,15
Gujarat,Patan,PARMAR MAGANBHAI AMARABHAI,Bahujan Samaj Party,9842,58,9900,1
Gujarat,Patan,RATHOD BHAVSINHBHAI DAHYABHAI,Indian National Congress,376973,2846,379819,2
Gujarat,Patan,LILADHARBHAI KHODAJI VAGHELA,Bharatiya Janata Party,515579,2959,518538,3
Gujarat,Patan,GOVINDJI OKHAJI THAKOR,Janata Dal (United),6164,24,6188,4
Gujarat,Patan,JAKASIJI JOGAJI THAKOR,Bahujan Mukti Party,2716,44,2760,5
Gujarat,Patan,PARMAR BHAICHANDBHAI SOMABHAI,Republician Party of India Ektawadi,895,15,910,6
Gujarat,Patan,BABUBHAI KARSHANBHAI RABARI,Samajwadi Party,1827,16,1843,7
Gujarat,Patan,IMRANKHAN MAHMADKHAN NAGORI,Independent,1838,2,1840,8
Gujarat,Patan,CHHAGANBHAI NARANBHAI PRAJAPATI,Independent,2523,16,2539,9
Gujarat,Patan,JAGRALA  IMRAN MAHEMUD,Independent,1962,16,1978,10
Gujarat,Patan,DESAI ISHWARBHAI MAHADEVBHAI,Independent,1736,16,1752,11
Gujarat,Patan,BHORANIYA SOYABBHAI HASAMBHAI,Independent,2544,6,2550,12
Gujarat,Patan,MOLAPIYA ABDULKUDUS ABDULMAJID,Independent,5627,2,5629,13
Gujarat,Patan,VAGHDA JIVABHAI DEVABHAI,Independent,7483,9,7492,14
Gujarat,Patan,None of the Above,NOTA,11970,91,12061,15
Gujarat,Mahesana,THAKOR KEVALJI NATHAJI,Bahujan Samaj Party,9675,91,9766,1
Gujarat,Mahesana,PATEL JAYSHREEBEN KANUBHAI,Bharatiya Janata Party,577225,3025,580250,2
Gujarat,Mahesana,PATEL JIVABHAI AMBALAL,Indian National Congress,368204,3155,371359,3
Gujarat,Mahesana,GIRISHJI JENAJI DABHI,BNJD,4813,12,4825,4
Gujarat,Mahesana,CHAUDHARY DINESHBHAI SALUBHAI,Vishva Hindustani Sangathan,1069,15,1084,5
Gujarat,Mahesana,ZALA INDRAJITSINH MAHENDRASINH,Samajwadi Party,1327,13,1340,6
Gujarat,Mahesana,THAKOR MANSANGJI PUNJAJI,Bahujan Mukti Party,1241,10,1251,7
Gujarat,Mahesana,PATEL DILIPBHAI SOMABHAI,Hindustan Janta Party,1032,0,1032,8
Gujarat,Mahesana,SMT VANDANABEN DINESHKUMAR PATEL,Aam Aadmi Party,3659,72,3731,9
Gujarat,Mahesana,THAKOR BALDEVJI MAGANJI,Independent,1622,31,1653,10
Gujarat,Mahesana,THAKOR BABUJI DHANAJI,Independent,1780,24,1804,11
Gujarat,Mahesana,THAKOR SAMARATJI BALVANTSINH,Independent,2424,3,2427,12
Gujarat,Mahesana,PRAJAPATI VITTHALBHAI VIRDAS,Independent,5977,5,5982,13
Gujarat,Mahesana,MAHMAD AZAM HAIDERKHAN PATHAN,Independent,6133,6,6139,14
Gujarat,Mahesana,None of the Above,NOTA,11554,61,11615,15
Gujarat,Sabarkantha,BHAMBHI CHANDUBHAI MULCHANDBHAI,Bahujan Samaj Party,16622,43,16665,1
Gujarat,Sabarkantha,RATHOD DIPSINH SHANKARSINH,Bharatiya Janata Party,549061,3144,552205,2
Gujarat,Sabarkantha,SHANKERSINH VAGHELA BAPU,Indian National Congress,463024,4726,467750,3
Gujarat,Sabarkantha,PATEL BHOGILAL HARIBHAI,BNJD,9028,18,9046,4
Gujarat,Sabarkantha,SHEKH ARIF KHAN,Samajwadi Party,2312,2,2314,5
Gujarat,Sabarkantha,PATEL ISHWARBHAI SAKRAJI,Independent,1668,6,1674,6
Gujarat,Sabarkantha,PATEL PURUSOTTAMBHAI AMBALAL,Independent,1869,7,1876,7
Gujarat,Sabarkantha,BALUSINGH SOMANSINGH NARVE,Independent,3516,11,3527,8
Gujarat,Sabarkantha,VELANI SHANTILAL KARAMSHI,Independent,6810,6,6816,9
Gujarat,Sabarkantha,SOLANKI CHHAGANBHAI KEVALABHAI,Independent,9790,5,9795,10
Gujarat,Sabarkantha,None of the Above,NOTA,22270,64,22334,11
Gujarat,Gandhinagar,L.K.ADVANI,Bharatiya Janata Party,770118,3421,773539,1
Gujarat,Gandhinagar,KIRITBHAI ISHVARBHAI PATEL,Indian National Congress,287584,2834,290418,2
Gujarat,Gandhinagar,NIRANJAN GHOSH,Bahujan Samaj Party,6018,50,6068,3
Gujarat,Gandhinagar,AJMALBHAI RAMABHAI VANIYA,Bahujan Mukti Party,1626,13,1639,4
Gujarat,Gandhinagar,THAKOR RAVAJI JUHAJI,Vishva Hindustani Sangathan,793,16,809,5
Gujarat,Gandhinagar,PATEL PIYUSHKUMAR DASHRATHLAL,Nayee Party,649,4,653,6
Gujarat,Gandhinagar,MANOJ J. NAYAK,LoRP,682,1,683,7
Gujarat,Gandhinagar,RITURAJ MEHTA,Aam Aadmi Party,19720,246,19966,8
Gujarat,Gandhinagar,THAKOR CHANDRASINH JAVANSINH,Independent,661,7,668,9
Gujarat,Gandhinagar,DIPIKABEN SUTARIYA,Independent,676,8,684,10
Gujarat,Gandhinagar,DESAI KHODABHAI LALJIBHAI,Independent,780,13,793,11
Gujarat,Gandhinagar,PAGI GANPATBHAI MAVJIBHAI,Independent,923,1,924,12
Gujarat,Gandhinagar,BIRJUSINH MOTISINH KSHATRIYA,Independent,984,0,984,13
Gujarat,Gandhinagar,BRAHMBHATT SANJAYBHAI AMARKUMAR,Independent,1467,7,1474,14
Gujarat,Gandhinagar,RAJ PRAJAPATI,Independent,3170,7,3177,15
Gujarat,Gandhinagar,RAHUL CHIMANBHAI MEHTA,Independent,9762,5,9767,16
Gujarat,Gandhinagar,VAGHELA KISHORSINH MAHOBATSINH,Independent,6685,20,6705,17
Gujarat,Gandhinagar,M. K. SHAH,Independent,3765,2,3767,18
Gujarat,Gandhinagar,None of the Above,NOTA,12593,184,12777,19
Gujarat,Ahmedabad East,PATEL HIMMATSINGH PRAHLADSINGH,Indian National Congress,304769,2180,306949,1
Gujarat,Ahmedabad East,PARESH RAWAL,Bharatiya Janata Party,630869,2713,633582,2
Gujarat,Ahmedabad East,ROHIT RAJUBHAI VIRJIBHAI ALIAS MANOJBHAI SONTARIYA,Bahujan Samaj Party,5970,53,6023,3
Gujarat,Ahmedabad East,ADITYA RAVAL,Vishva Hindustani Sangathan,985,2,987,4
Gujarat,Ahmedabad East,KHALIFA SAMSUDDIN NASIRUDDIN (JUGNU),ABCD(A),866,29,895,5
Gujarat,Ahmedabad East,DUTT AAKASH - ADVOCATE,Janata Dal (United),555,3,558,6
Gujarat,Ahmedabad East,DINESH VAGHELA,Aam Aadmi Party,11208,141,11349,7
Gujarat,Ahmedabad East,NARANBHAI T. SENGAL (DR.N.T.SENGAL),BSDL,778,4,782,8
Gujarat,Ahmedabad East,BUDDHPRIYA JASVANT SOMABHAI,PAP,686,12,698,9
Gujarat,Ahmedabad East,VIJAYKUMAR M. VADHEL,HND,687,17,704,10
Gujarat,Ahmedabad East,ATIKBHAI MEV,Independent,1091,3,1094,11
Gujarat,Ahmedabad East,ANILKUMAR SHARMA,Independent,1199,2,1201,12
Gujarat,Ahmedabad East,DASHRATHBHAI M. DEVDA,Independent,2296,3,2299,13
Gujarat,Ahmedabad East,ROSHAN PRIYAVADAN SHAH,Independent,4045,1,4046,14
Gujarat,Ahmedabad East,None of the Above,NOTA,14261,97,14358,15
Gujarat,Ahmedabad West,ISHWARBAHI DHANABHAI MAKWANA,Indian National Congress,295202,1591,296793,1
Gujarat,Ahmedabad West,DR. KIRIT P SOLANKI,Bharatiya Janata Party,614892,2212,617104,2
Gujarat,Ahmedabad West,CHAVDA MANSUKHBHAI NAGARBHAI,Bahujan Samaj Party,6180,25,6205,3
Gujarat,Ahmedabad West,AMRUT SONARA,BSDL,937,4,941,4
Gujarat,Ahmedabad West,NARENDRA SANKHALIYA,Loktantrik Samajwadi Party,1378,13,1391,5
Gujarat,Ahmedabad West,DR J G PARMAR,Bahujan Mukti Party,2539,25,2564,6
Gujarat,Ahmedabad West,J J MEVADA,Aam Aadmi Party,17184,148,17332,7
Gujarat,Ahmedabad West,AAYAR MULJIBHAI KHANABHAI,Independent,801,7,808,8
Gujarat,Ahmedabad West,PARMAR HARJIVANBHAI KALABHAI,Independent,806,1,807,9
Gujarat,Ahmedabad West,SOLANKI RAMESHBHAI DANABHAI,Independent,1254,2,1256,10
Gujarat,Ahmedabad West,SOLANKI VITTHALBHAI MAGANBHAI,Independent,2835,2,2837,11
Gujarat,Ahmedabad West,None of the Above,NOTA,16467,104,16571,12
Gujarat,Surendranagar,KOLI PATEL SOMABHAI GANDALAL,Indian National Congress,323684,2412,326096,1
Gujarat,Surendranagar,PARMAR MINAXIBEN VIJAYBHAI,Bahujan Samaj Party,10622,131,10753,2
Gujarat,Surendranagar,FATEPARA DEVAJIBHAI GOVINDBHAI,Bharatiya Janata Party,526006,2997,529003,3
Gujarat,Surendranagar,JETHABHAI MANJIBHAI PATEL,Aam Aadmi Party,13266,109,13375,4
Gujarat,Surendranagar,BAR AJAMALBHAI KARMANBHAI,Bahujan Mukti Party,2227,24,2251,5
Gujarat,Surendranagar,MAJETHIYA SAMARATBHAI JERAMBHAI,Hindustan Janta Party,1334,7,1341,6
Gujarat,Surendranagar,CHAVDA PALABHAI NANJIBHAI,Independent,1222,5,1227,7
Gujarat,Surendranagar,PARMAR PRABHUBHAI GOKALBHAI,Independent,2956,12,2968,8
Gujarat,Surendranagar,PARMAR VASHARAMBHAI BAVALBHAI,Independent,1744,7,1751,9
Gujarat,Surendranagar,MAKWANA UKABHAI AMRABHAI,Independent,1193,33,1226,10
Gujarat,Surendranagar,MAKWANA VASHARAMBHAI KARSHANBHAI,Independent,1397,16,1413,11
Gujarat,Surendranagar,MANSINH SHIVUBHA ZALA,Independent,2066,88,2154,12
Gujarat,Surendranagar,VADALIYA KALUBHAI MALUBHAI,Independent,3096,6,3102,13
Gujarat,Surendranagar,VAGHELA PRAKASHBHAI BACHUBHAI,Independent,6432,7,6439,14
Gujarat,Surendranagar,VORA BHAVANBHAI DEVAJIBHAI,Independent,4811,7,4818,15
Gujarat,Surendranagar,SAPARA VIPULBHAI RAMESHBHAI,Independent,14511,4,14515,16
Gujarat,Surendranagar,SANKALIYA GANGARAMBHAI TAPUBHAI,Independent,11214,2,11216,17
Gujarat,Surendranagar,None of the Above,NOTA,10794,235,11029,18
Gujarat,Rajkot,KUNDARIYA MOHANBHAI KALYANJIBHAI,Bharatiya Janata Party,619495,2029,621524,1
Gujarat,Rajkot,KUNVARJIBHAI MOHANBHAI BAVALIYA,Indian National Congress,373032,2064,375096,2
Gujarat,Rajkot,JIVANBHAI DEVAJIBHAI PARMAR,Bahujan Samaj Party,12594,59,12653,3
Gujarat,Rajkot,ANKUR AMRUTKUMAR DHAMELIYA(PATEL),Aam Aadmi Party,10709,76,10785,4
Gujarat,Rajkot,JITENDRA BHURABHAI CHAUHAN,Republican Party of India (Khobragade),989,1,990,5
Gujarat,Rajkot,DENGADA PRAVINBHAI MEGHAJIBHAI,Republican Party of India (A),945,0,945,6
Gujarat,Rajkot,RAJESHBHAI LAVJIBHAI PIPALVA,LoRP,807,1,808,7
Gujarat,Rajkot,ROHITBHAI MOHANBHAI SAGATHIYA,Bahujan Mukti Party,1333,11,1344,8
Gujarat,Rajkot,ANIRUDDHSINH JUVANSINH ZALA,Independent,1562,74,1636,9
Gujarat,Rajkot,NARENDRABHAI MAHAJAN,Independent,1152,9,1161,10
Gujarat,Rajkot,PATHAN BISMILLAKHAN ABDULKHAN (BABAKHAN PATHAN),Independent,1062,18,1080,11
Gujarat,Rajkot,POPATBHAI DEVAJIBHAI CHAVDA (BHUVA),Independent,1401,7,1408,12
Gujarat,Rajkot,PRAVINCHANDRA CHUNILAL PAREKH,Independent,1559,3,1562,13
Gujarat,Rajkot,BASIRBHAI SULEMANBHAI SAMA,Independent,2070,6,2076,14
Gujarat,Rajkot,VINODBHAI PRAGJIBHAI NAGANI,Independent,5748,4,5752,15
Gujarat,Rajkot,None of the Above,NOTA,18137,112,18249,16
Gujarat,Porbandar,JADEJA KANDHALBHAI SARAMANBHAI,Nationalist Congress Party,238360,2106,240466,1
Gujarat,Porbandar,RADADIYA VITHALBHAI  HANSRAJBHAI,Bharatiya Janata Party,506002,2435,508437,2
Gujarat,Porbandar,SADIYA VRAJALAL PABABHAI,Bahujan Samaj Party,12064,116,12180,3
Gujarat,Porbandar,IRFANSHAH HABIBSHAH SUHARAVARDI,Samajwadi Party,3808,17,3825,4
Gujarat,Porbandar,MANSUKH SUNDARAJI DHOKAI,Aam Aadmi Party,7847,92,7939,5
Gujarat,Porbandar,AGHERA DHIRAJLAL BHURABHAI,Independent,1666,5,1671,6
Gujarat,Porbandar,UNADAKAT PRAKASH VALLABHADAS,Independent,1616,2,1618,7
Gujarat,Porbandar,KHUNTI BHARATBHAI MALDEBHAI,Independent,2199,6,2205,8
Gujarat,Porbandar,KHOKHANI LALITABEN MANSUKHBHAI,Independent,1540,29,1569,9
Gujarat,Porbandar,JOSHI HARISH LILADHAR,Independent,987,37,1024,10
Gujarat,Porbandar,TUKADIA G.R.,Independent,1696,8,1704,11
Gujarat,Porbandar,PATEL BUTANI RAJESHBHAI MAGANBHAI,Independent,2864,4,2868,12
Gujarat,Porbandar,RATHOD CHANDULAL MOHANLAL,Independent,2996,13,3009,13
Gujarat,Porbandar,VAKIL VINZUDA RANJITBHAI NARANBHAI,Independent,4466,9,4475,14
Gujarat,Porbandar,None of the Above,NOTA,16304,139,16443,15
Gujarat,Jamnagar,AHIR VIKRAMBHAI ARJANBHAI MADAM,Indian National Congress,307836,1287,309123,1
Gujarat,Jamnagar,POONAMBEN HEMATBHAI MAADAM,Bharatiya Janata Party,482451,1961,484412,2
Gujarat,Jamnagar,SAMA YUSUF,Bahujan Samaj Party,8197,37,8234,3
Gujarat,Jamnagar,KASAMBHAI,RKEP,1248,6,1254,4
Gujarat,Jamnagar,JHALA RAJENDRASINH,Aam Aadmi Party,4767,144,4911,5
Gujarat,Jamnagar,SAIYAD ABUBAKAR IBRAHIM,Samajwadi Party,934,6,940,6
Gujarat,Jamnagar,CHANDRAVIJAYSINH TAKHUBHA RANA,Independent,861,15,876,7
Gujarat,Jamnagar,DALIT ASHOK NATHABHAI CHAVDA,Independent,733,11,744,8
Gujarat,Jamnagar,DALIT JITESH BABUBHAI RATHORE,Independent,702,4,706,9
Gujarat,Jamnagar,DHANJIBHAI LALJIBHAI RANEVADIA,Independent,770,7,777,10
Gujarat,Jamnagar,DHARAVIYA VALLABHBHAI,Independent,1032,11,1043,11
Gujarat,Jamnagar,NARIYA PRAVINBHAI VALLABHBHAI,Independent,1807,4,1811,12
Gujarat,Jamnagar,PADHIYAR LALJIBHAI KARABHAI,Independent,1177,11,1188,13
Gujarat,Jamnagar,PANDYA CHIRAGBHAI HARIOMBHAI,Independent,1535,6,1541,14
Gujarat,Jamnagar,BATHWAR NANJIBHAI,Independent,3664,3,3667,15
Gujarat,Jamnagar,MAMAD HAJI BOLIM,Independent,8594,2,8596,16
Gujarat,Jamnagar,MEMAN RAFIK ABUBAKAR POPATPUTRA,Independent,5808,3,5811,17
Gujarat,Jamnagar,VAGHER ALI ISHAK PALANI,Independent,3943,3,3946,18
Gujarat,Jamnagar,VAGHER JAVIDBHAI OSMANBHAI NOLE,Independent,1245,2,1247,19
Gujarat,Jamnagar,VANIYA GANGAJIBHAI,Independent,783,12,795,20
Gujarat,Jamnagar,SACHADA HABIB ISHABHAI,Independent,816,3,819,21
Gujarat,Jamnagar,SUTHAR HANSABEN HARSUKHBHAI GORECHA,Independent,588,4,592,22
Gujarat,Jamnagar,SUMARA AMANDBHAI NOORMAMADBHAI SUMARA,Independent,759,1,760,23
Gujarat,Jamnagar,SODHA SALIMBHAI NURMAMADBHAI,Independent,885,0,885,24
Gujarat,Jamnagar,SANDHI MAMADBHAI HAJIBHAI SAFIA,Independent,1377,0,1377,25
Gujarat,Jamnagar,None of the Above,NOTA,6543,45,6588,26
Gujarat,Junagadh,CHUDASAMA RAJESHBHAI NARANBHAI,Bharatiya Janata Party,511017,2162,513179,1
Gujarat,Junagadh,PUNJABHAI BHIMABHAI VANSH,Indian National Congress,375897,1450,377347,2
Gujarat,Junagadh,ATUL GOVINDBHAI SHEKHADA,Aam Aadmi Party,16567,107,16674,3
Gujarat,Junagadh,KADRI IBRAHIM SAIYED HUSEN,Samajwadi Party,2387,22,2409,4
Gujarat,Junagadh,SOLANKI HARIBHAI BOGHABHAI,Bahujan Mukti Party,2538,27,2565,5
Gujarat,Junagadh,GADHIYA SOYEB HUSHENBHAI,Independent,1871,20,1891,6
Gujarat,Junagadh,SAIYED ALTAF HUSAIN ABDULLAH MIYAN,Independent,2702,15,2717,7
Gujarat,Junagadh,HARILAL RANCHHODBHAI CHAUHAN,Independent,7558,16,7574,8
Gujarat,Junagadh,None of the Above,NOTA,16944,78,17022,9
Gujarat,Amreli,KACHHADIYA NARANBHAI BHIKHABHAI,Bharatiya Janata Party,435132,1583,436715,1
Gujarat,Amreli,THUMMAR VIRJIBHAI KESHAVBHAI (VIRJIBHAI THUMMAR),Indian National Congress,279138,1345,280483,2
Gujarat,Amreli,DAFADA RAMJIBHAI NANJIBHAI,Bahujan Samaj Party,7774,48,7822,3
Gujarat,Amreli,CHAVADA MANUBHAI PARSHOTTMBHAI,Janata Dal (United),13706,97,13803,4
Gujarat,Amreli,RATHOD JIVANBHAI R.,Republican Party of India (A),1789,20,1809,5
Gujarat,Amreli,SANGANI VIJAYBHAI DINESHBHAI,YuS,1931,7,1938,6
Gujarat,Amreli,SUKHADIYA NATHALAL VALLABHBHAI,Aam Aadmi Party,15441,79,15520,7
Gujarat,Amreli,USMANBHAI P. MAGHARA,Independent,2210,6,2216,8
Gujarat,Amreli,JADAV MUSTAKBHAI,Independent,1539,14,1553,9
Gujarat,Amreli,DHIMECHA NARESHBHAI NANJIBHAI,Independent,2053,9,2062,10
Gujarat,Amreli,NATHABHAI DAYABHAI TOTA,Independent,4023,9,4032,11
Gujarat,Amreli,MEHULBHAI HIMATBHAI SUKHADIA,Independent,3433,6,3439,12
Gujarat,Amreli,RAMANI SURESHBHAI DHIRUBHAI,Independent,10108,6,10114,13
Gujarat,Amreli,VALODARA VRAJLAL JIVABHAI,Independent,8163,4,8167,14
Gujarat,Amreli,None of the Above,NOTA,19065,78,19143,15
Gujarat,Bhavnagar,GITA CHETAN PAUNDA (ADVOCATE GITABA JADEJA),Bahujan Samaj Party,9298,47,9345,1
Gujarat,Bhavnagar,DR. BHARATIBEN DHIRUBHAI SHIYAL,Bharatiya Janata Party,547080,2449,549529,2
Gujarat,Bhavnagar,RATHOD PRAVINBHAI JINABHAI,Indian National Congress,252901,1140,254041,3
Gujarat,Bhavnagar,DR. KANUBHAI V. KALSARIA,Aam Aadmi Party,49117,423,49540,4
Gujarat,Bhavnagar,KAGADA RAMESHBHAI PUNABHAI,Independent,3531,11,3542,5
Gujarat,Bhavnagar,KHADRANI ASIMBHAI PIRBHAI,Independent,1358,1,1359,6
Gujarat,Bhavnagar,GOHIL PRAVINSINH DHIRUBHA,Independent,2187,89,2276,7
Gujarat,Bhavnagar,GOHEL BHARATBHAI BHIMABHAI,Independent,1732,2,1734,8
Gujarat,Bhavnagar,JAGADISHBHAI AMARABHAI VEGAD,Independent,1521,4,1525,9
Gujarat,Bhavnagar,BHAVES GHANSHYAMBHAI RAJYAGURU,Independent,5835,77,5912,10
Gujarat,Bhavnagar,MEHTA YASHVANTRAY ODHAVJIBHAI,Independent,1844,8,1852,11
Gujarat,Bhavnagar,MARU MANHAR VALAJIBHAI,Independent,2247,10,2257,12
Gujarat,Bhavnagar,RASIDKHAN HASANKHAN PATHAN,Independent,2691,16,2707,13
Gujarat,Bhavnagar,RATHOD PRAVINSINH CHANDRASINH,Independent,5518,12,5530,14
Gujarat,Bhavnagar,VAGHELA NARENDRABHAI SHAVJIBHAI,Independent,9101,12,9113,15
Gujarat,Bhavnagar,VEGAD NATHABHAI (VEGADBHAI PRAGNACHAKSHU CANDIDATE),Independent,7547,3,7550,16
Gujarat,Bhavnagar,None of the Above,NOTA,9484,106,9590,17
Gujarat,Anand,DILIP PATEL,Bharatiya Janata Party,489507,1322,490829,1
Gujarat,Anand,PURSOTTAMBHAI ALIAS KANUBHAI MATHURBHAI CHAUHAN,Bahujan Samaj Party,6459,21,6480,2
Gujarat,Anand,SOLANKI BHARATBHAI MADHAVSINH,Indian National Congress,425251,2152,427403,3
Gujarat,Anand,GIRISHBHAI DAS (ADVOCATE),Bahujan Mukti Party,3993,10,4003,4
Gujarat,Anand,PADHIYAR VIKRAMSINH (VAKIL),RSPS,873,3,876,5
Gujarat,Anand,MAHIDA MAHENDRASINH SAHEBSINH,Samajwadi Party,1786,4,1790,6
Gujarat,Anand,RAVJIBHAI S PARMAR,Aam Aadmi Party,2407,35,2442,7
Gujarat,Anand,HITENDRASINH MOHANSINH PARMAR,BNJD,1255,5,1260,8
Gujarat,Anand,PATEL JAYESHBHAI ARVINDBHAI,Independent,1445,14,1459,9
Gujarat,Anand,PATEL DILIPBHAI MANILAL,Independent,1378,88,1466,10
Gujarat,Anand,PATEL NAINESHKUMAR UMEDBHAI,Independent,1050,13,1063,11
Gujarat,Anand,PARMAR AMARSINH DAHYABHAI,Independent,1262,3,1265,12
Gujarat,Anand,RABARI HITESHKUMAR LALJIBHAI,Independent,2969,6,2975,13
Gujarat,Anand,VAHORA FIROJBHAI WALIMAHAMADBHAI (KASORWALA),Independent,6688,1,6689,14
Gujarat,Anand,VAGHELA BHARAT P,Independent,4006,16,4022,15
Gujarat,Anand,None of the Above,NOTA,16850,22,16872,16
Gujarat,Kheda,CHAUHAN DEVUSINH JESINGBHAI (CHAUHAN DEVUSINH),Bharatiya Janata Party,565826,2409,568235,1
Gujarat,Kheda,DINSHA PATEL,Indian National Congress,333325,2009,335334,2
Gujarat,Kheda,PANDAV BHAILALBHAI KALUBHAI,Bahujan Samaj Party,5757,34,5791,3
Gujarat,Kheda,ABDUL RAZAKKHAN PATHAN,ADPT,1019,5,1024,4
Gujarat,Kheda,BADHIWALA LABHUBHAI JIVRAJBHAI,Aam Aadmi Party,3717,25,3742,5
Gujarat,Kheda,RANVEER PRANAYRAJ GOVINDBHAI,Bahujan Mukti Party,936,8,944,6
Gujarat,Kheda,KHRISTI ADWARD KHUSHALBHAI,Independent,935,3,938,7
Gujarat,Kheda,CHAUHAN DEVUSING MOTISHING,Independent,1844,16,1860,8
Gujarat,Kheda,PATHAN AMANULLAKHA SITABKHA,Independent,801,2,803,9
Gujarat,Kheda,PARIKH VIRAL HASMUKHBHAI,Independent,836,10,846,10
Gujarat,Kheda,MALEK YAKUBMIYA NABIMIYA,Independent,952,3,955,11
Gujarat,Kheda,MALEK SADIK HUSHEN MAHAMMD HUSHEN,Independent,1441,3,1444,12
Gujarat,Kheda,MALEK SABIRHUSEN ISMAELBHAI,Independent,2720,0,2720,13
Gujarat,Kheda,RATANSINH UDESINH CHAUHAN,Independent,3493,2,3495,14
Gujarat,Kheda,ROSHAN PRIYAVADAN SHAH,Independent,7442,0,7442,15
Gujarat,Kheda,None of the Above,NOTA,20279,54,20333,16
Gujarat,Panchmahal,GIRI RAMCHANDRA VAIJNATH,Bahujan Samaj Party,15899,57,15956,1
Gujarat,Panchmahal,CHAUHAN PRABHATSINH PRATAPSINH,Bharatiya Janata Party,504707,3567,508274,2
Gujarat,Panchmahal,RAMSINH PARMAR,Indian National Congress,335020,2658,337678,3
Gujarat,Panchmahal,PIYUSHKUMAR DILIPBHAI PARMAR,Aam Aadmi Party,6870,65,6935,4
Gujarat,Panchmahal,SHAIKH KALIM ABDULLATIF,Samajwadi Party,1985,8,1993,5
Gujarat,Panchmahal,SHAIKH MAJITMIYA JIVAMIYA,Janata Dal (United),1334,3,1337,6
Gujarat,Panchmahal,GORA SHOEB MOHMADHANIF,Independent,1497,0,1497,7
Gujarat,Panchmahal,S. N. CHAVADA (CHAVADA VAKIL),Independent,2388,13,2401,8
Gujarat,Panchmahal,CHAVADA HARISHCHANDRASINH PRABHATSINH,Independent,3733,18,3751,9
Gujarat,Panchmahal,PATEL PANKAJBHAI RAVJIBHAI,Independent,5401,25,5426,10
Gujarat,Panchmahal,MANSURI MUKHATYAR MOHAMMAD (PANTER M. LALA),Independent,10856,1,10857,11
Gujarat,Panchmahal,VANKAR MANILAL BHANABHAI,Independent,11357,18,11375,12
Gujarat,Panchmahal,None of the Above,NOTA,25943,38,25981,13
Gujarat,Dahod,KATARA SINGAJIBHAI JALJIBHAI,Communist Party of India  (Marxist),28908,50,28958,1
Gujarat,Dahod,JASVANTSINH SUMANBHAI BHABHOR,Bharatiya Janata Party,508838,2273,511111,2
Gujarat,Dahod,TAVIYAD DR. PRABHABEN KISHORSINH,Indian National Congress,278170,2587,280757,3
Gujarat,Dahod,BAMANIYA JYOTISHKUMAR BAPUBHAI,Bahujan Samaj Party,11221,12,11233,4
Gujarat,Dahod,BHABHOR MAVJIBHAI TITUBHAI,Samajwadi Party,4157,10,4167,5
Gujarat,Dahod,K.C.MUNIA ADVOCATE,Aam Aadmi Party,4805,44,4849,6
Gujarat,Dahod,MEDA JAGDISHBHAI MANILAL,BNJD,5058,20,5078,7
Gujarat,Dahod,RAMSINGBHAI NANJIBHAI KALARA,Janata Dal (United),3822,19,3841,8
Gujarat,Dahod,KUMARI INDUBEN NATHUBHAI SANGADA,Independent,6827,11,6838,9
Gujarat,Dahod,BHURA NAVALABHAI MANABHAI,Independent,11237,7,11244,10
Gujarat,Dahod,None of the Above,NOTA,32268,37,32305,11
Gujarat,Vadodara,NARENDRA MODI,Bharatiya Janata Party,841592,3872,845464,1
Gujarat,Vadodara,MISTRI MADHUSUDAN DEVRAM,Indian National Congress,273589,1747,275336,2
Gujarat,Vadodara,ROHIT MADHUSUDAN MOHANBHAI,Bahujan Samaj Party,5685,97,5782,3
Gujarat,Vadodara,JADAV AMBALAL KANABHAI,Janata Dal (United),1375,7,1382,4
Gujarat,Vadodara,TAPAN DASGUPTA,SOCIALIST UNITY CENTRE OF INDIA (COMMUNIST),2244,5,2249,5
Gujarat,Vadodara,PATHAN MAHEMUDKHAN RAZAKKHAN,ADPT,1103,6,1109,6
Gujarat,Vadodara,PATHAN SAHEBKHAN ASIFKHAN,Samajwadi Party,2098,3,2101,7
Gujarat,Vadodara,SUNIL DIGAMBAR KULKARNI,Aam Aadmi Party,9997,104,10101,8
Gujarat,Vadodara,None of the Above,NOTA,17973,80,18053,9
Gujarat,Chhota Udaipur,NARANBHAI JEMALABHAI RATHVA,Indian National Congress,425511,2676,428187,1
Gujarat,Chhota Udaipur,RAMSINH RATHWA,Bharatiya Janata Party,604843,3073,607916,2
Gujarat,Chhota Udaipur,PROF. ARJUNBHAI VERSINGBHAI RATHVA,Aam Aadmi Party,22961,155,23116,3
Gujarat,Chhota Udaipur,VASAVA PRAFULBHAI DEVJIBHAI,Janata Dal (United),12460,48,12508,4
Gujarat,Chhota Udaipur,None of the Above,NOTA,28767,48,28815,5
Gujarat,Bharuch,PATEL JAYESHBHAI AMBALALBHAI (JAYESH KAKA),Indian National Congress,394318,1311,395629,1
Gujarat,Bharuch,VASAVA MANSUKHBHAI DHANJIBHAI,Bharatiya Janata Party,546740,2162,548902,2
Gujarat,Bharuch,SUKHRAMSINGH,Bahujan Samaj Party,7236,39,7275,3
Gujarat,Bharuch,ANILKUMAR CHHITUBHAI BHAGAT,Janata Dal (United),49146,143,49289,4
Gujarat,Bharuch,JAYENDRASINH RANA,Aam Aadmi Party,4751,67,4818,5
Gujarat,Bharuch,SAYYED ASIF ZAFAR ALI,ADPT,1079,4,1083,6
Gujarat,Bharuch,SAIYAD MOHSIN BAPU NANUMIYAWALA,Bahujan Mukti Party,1402,4,1406,7
Gujarat,Bharuch,ANANDKUMAR SARVARSINH VASAVA,Independent,1840,15,1855,8
Gujarat,Bharuch,NITIN ISHWARLAL VAKIL (ADVOCATE),Independent,2631,30,2661,9
Gujarat,Bharuch,BHURA SHABBIRBHAI VALIBHAI,Independent,2670,24,2694,10
Gujarat,Bharuch,RAFIKBHAI SULEMAN SAPA,Independent,2627,17,2644,11
Gujarat,Bharuch,VIRSANGBHAI PARBATBHAI GOHIL,Independent,3338,15,3353,12
Gujarat,Bharuch,SHAILESHKUMAR MAGANBHAI PARMAR,Independent,5115,10,5125,13
Gujarat,Bharuch,SINDHI MAYYUDEEN UMARBHAI,Independent,9856,6,9862,14
Gujarat,Bharuch,None of the Above,NOTA,23570,45,23615,15
Gujarat,Bardoli,GAMIT MOVALIYABHAI NOPARIYABHAI,Bahujan Samaj Party,11586,39,11625,1
Gujarat,Bardoli,CHAUDHARI TUSHARBHAI AMARSINHBHAI,Indian National Congress,496293,2592,498885,2
Gujarat,Bardoli,CHAUDHARI REVABEN SHANKARBHAI,Communist Party of India,13249,21,13270,3
Gujarat,Bardoli,VASAVA PARBHUBHAI NAGARBHAI,Bharatiya Janata Party,621188,1581,622769,4
Gujarat,Bardoli,CHAUDHARI CHANDUBHAI MACHALABHAI,Aam Aadmi Party,10777,65,10842,5
Gujarat,Bardoli,CHAUDHARI RENIYABHAI SHANKARBHAI,HND,2181,3,2184,6
Gujarat,Bardoli,JAGATSINH LALJIBHAI VASAVA,Janata Dal (United),7256,65,7321,7
Gujarat,Bardoli,BHAILALBHAI CHHANABHAI RATHOD,ADSP,5317,17,5334,8
Gujarat,Bardoli,GAMIT SURENDRABHAI SIMABHAI,Independent,5328,23,5351,9
Gujarat,Bardoli,RATHOD RAMESHBHAI BHIKHABHAI,Independent,8602,5,8607,10
Gujarat,Bardoli,None of the Above,NOTA,19935,56,19991,11
Gujarat,Surat,OMPRAKASH SHRIVASTAV,Bahujan Samaj Party,6336,10,6346,1
Gujarat,Surat,DARSHANA VIKRAM JARDOSH,Bharatiya Janata Party,717429,983,718412,2
Gujarat,Surat,DESAI NAISHADHBHAI BHUPATBHAI,Indian National Congress,184904,318,185222,3
Gujarat,Surat,KIRITBHAI HARJIBHAI VASANI,YuS,2639,1,2640,4
Gujarat,Surat,MOHANBHAI B. PATEL,Aam Aadmi Party,18824,53,18877,5
Gujarat,Surat,VASAVA KISHORBHAI CHHOTUBHAI,Janata Dal (United),1177,10,1187,6
Gujarat,Surat,MAVJIBHAI LAXMANBHAI SANDIS,Independent,1604,3,1607,7
Gujarat,Surat,MUKESHBHAI LAVJIBHAI AMBALIYA,Independent,2694,1,2695,8
Gujarat,Surat,None of the Above,NOTA,10900,36,10936,9
Gujarat,Navsari,CHAUHAN KESHAVBHAI MALABHAI (MASTER),Bahujan Samaj Party,11218,22,11240,1
Gujarat,Navsari,C. R. PATIL,Bharatiya Janata Party,818367,2464,820831,2
Gujarat,Navsari,MAKSUD MIRZA,Indian National Congress,261848,867,262715,3
Gujarat,Navsari,ASLAM MISTRY,BBC,3805,48,3853,4
Gujarat,Navsari,PATEL BHUPENDRAKUMAR DHIRUBHAI,Janata Dal (United),1258,6,1264,5
Gujarat,Navsari,PYARELAL BHARTI,HND,830,4,834,6
Gujarat,Navsari,MEHUL PATEL,Aam Aadmi Party,14163,136,14299,7
Gujarat,Navsari,WARDE RAJUBHAI BHIMRAO,Bahujan Mukti Party,2133,23,2156,8
Gujarat,Navsari,SONAL KELLOGG,VoP,1087,2,1089,9
Gujarat,Navsari,ARUN S. PATHAK(JOURNALIST),Independent,1020,10,1030,10
Gujarat,Navsari,KESHAVJI L. SARADVA,Independent,1055,4,1059,11
Gujarat,Navsari,PERCY MUNSHI,Independent,2231,4,2235,12
Gujarat,Navsari,RAMJAN MANSURI(JOURNALIST),Independent,1785,2,1787,13
Gujarat,Navsari,RAVSHAHEB BHIMRAV PATIL (BANDHU),Independent,2882,6,2888,14
Gujarat,Navsari,ROHIT GANDHI,Independent,4245,22,4267,15
Gujarat,Navsari,LATABEN ASHOKKUMAR DWIVEDI,Independent,7555,5,7560,16
Gujarat,Navsari,VIMAL PATEL (ENDHAL),Independent,2727,12,2739,17
Gujarat,Navsari,SAIYED MEHMUD AHMED,Independent,6066,3,6069,18
Gujarat,Navsari,HASAN SHAIKH,Independent,3507,3,3510,19
Gujarat,Navsari,None of the Above,NOTA,9232,90,9322,20
Gujarat,Valsad,KISHANBHAI  VESTABHAI PATEL,Indian National Congress,408003,1765,409768,1
Gujarat,Valsad,THAKRIYA RATILAL VAJIRBHAI,Bahujan Samaj Party,14150,52,14202,2
Gujarat,Valsad,DR. K.C.PATEL,Bharatiya Janata Party,616415,1357,617772,3
Gujarat,Valsad,GAURANGBHAI RAMESHBHAI PATEL,Hindustan Janta Party,11350,22,11372,4
Gujarat,Valsad,TALAVIYA BABUBHAI CHHAGANBHAI,Bahujan Mukti Party,2962,5,2967,5
Gujarat,Valsad,PATEL GOVINDBHAI RANCHHODBHAI,Aam Aadmi Party,7990,57,8047,6
Gujarat,Valsad,PATEL SHAILESHBHAI GANDABHAI,Janata Dal (United),2946,36,2982,7
Gujarat,Valsad,DR.PANKAJKUMAR PARBHUBHAI PATEL,ADSP,5976,52,6028,8
Gujarat,Valsad,VADIYA LAXMANBHAI CHHAGANBHAI,Communist Party of India (Marxist-Lenninist) (Liberation),9693,9,9702,9
Gujarat,Valsad,PATEL BUDHABHAI RANCHHODBHAI,Independent,12747,10,12757,10
Gujarat,Valsad,None of the Above,NOTA,26552,54,26606,11
Haryana,Ambala,ARUN KUMAR,Communist Party of India,11123,0,11123,1
Haryana,Ambala,DR. KAPOOR SINGH,Bahujan Samaj Party,102619,8,102627,2
Haryana,Ambala,DR. KUSUM SHERWAL,Indian National Lok Dal,129565,6,129571,3
Haryana,Ambala,RATTAN LAL KATARIA,Bharatiya Janata Party,611902,219,612121,4
Haryana,Ambala,RAJ KUMAR BALMIKI,Indian National Congress,272026,21,272047,5
Haryana,Ambala,RAJENDER KUMAR BHATAULI,Bhartiya Shakti Chetna Party,3432,0,3432,6
Haryana,Ambala,RAM JAWARI,RAKP,1290,0,1290,7
Haryana,Ambala,SURINDER PAL SINGH,Aam Aadmi Party,63608,18,63626,8
Haryana,Ambala,ISHWAR SINGH,Independent,1446,0,1446,9
Haryana,Ambala,GURNAM SINGH,Independent,933,0,933,10
Haryana,Ambala,PHOOL CHAND RATTUWALA,Independent,3095,0,3095,11
Haryana,Ambala,BHUPINDER KUMAR,Independent,3765,0,3765,12
Haryana,Ambala,BHURA RAM,Independent,3388,0,3388,13
Haryana,Ambala,RAMESH CHAND,Independent,2715,0,2715,14
Haryana,Ambala,None of the Above,NOTA,7816,0,7816,15
Haryana,Kurukshetra,CHATTAR SINGH,Bahujan Samaj Party,68921,5,68926,1
Haryana,Kurukshetra,NAVEEN JINDAL,Indian National Congress,287695,27,287722,2
Haryana,Kurukshetra,BALBIR SINGH SAINI,Indian National Lok Dal,288334,42,288376,3
Haryana,Kurukshetra,RAJ KUMAR SAINI,Bharatiya Janata Party,417961,151,418112,4
Haryana,Kurukshetra,ASHWANI MALHOTRA,All India Trinamool Congress,3251,0,3251,5
Haryana,Kurukshetra,ONKAR SINGH,NAJC,1483,0,1483,6
Haryana,Kurukshetra,KANTA ALLARIA,IBSPK,1534,0,1534,7
Haryana,Kurukshetra,KIRAN PAL,BIP,762,0,762,8
Haryana,Kurukshetra,KULDEEP SINGH MALLHI,Republican Party of India,1665,0,1665,9
Haryana,Kurukshetra,GURMEET SINGH,Lok Dal,1092,0,1092,10
Haryana,Kurukshetra,BALWINDER KAUR,Aam Aadmi Party,32538,16,32554,11
Haryana,Kurukshetra,RAM KISHAN,LPR,1635,0,1635,12
Haryana,Kurukshetra,RAMESHWAR KUMAR SAINI,Bhartiya Shakti Chetna Party,2344,0,2344,13
Haryana,Kurukshetra,ANIL KUMAR,Independent,1593,0,1593,14
Haryana,Kurukshetra,CHUNI MANOJ KUMAR,Independent,2770,0,2770,15
Haryana,Kurukshetra,JASVINDER JASHT BHUKHRI,Independent,3887,0,3887,16
Haryana,Kurukshetra,DAVINDER KUMAR,Independent,2041,0,2041,17
Haryana,Kurukshetra,MASTER DHARAMPAL DHIMAN BRAHAMAN,Independent,1994,0,1994,18
Haryana,Kurukshetra,RANBIR SINGH SHARMA,Independent,2765,0,2765,19
Haryana,Kurukshetra,RAJ KUMAR SAINI,Independent,6061,0,6061,20
Haryana,Kurukshetra,VISHNU BHAGWAN AGGARWAL,Independent,2083,0,2083,21
Haryana,Kurukshetra,CA. SATISH SINGAL,Independent,760,0,760,22
Haryana,Kurukshetra,None of the Above,NOTA,2482,0,2482,23
Haryana,Sirsa,ASHOK TANWAR,Indian National Congress,390615,19,390634,1
Haryana,Sirsa,CHARANJEET SINGH RORI,Indian National Lok Dal,506213,157,506370,2
Haryana,Sirsa,MANGERAM,Bahujan Samaj Party,20746,4,20750,3
Haryana,Sirsa,COMRADE RAM KUMAR,Communist Party of India  (Marxist),11188,6,11194,4
Haryana,Sirsa,DR. SUSHIL INDORA,HJCBL,241028,39,241067,5
Haryana,Sirsa,POONAM CHAND RATTI,Aam Aadmi Party,66834,10,66844,6
Haryana,Sirsa,BALWANT SINGH,BhSMP,2196,5,2201,7
Haryana,Sirsa,RAJ KUMAR NAGAR,Samajwadi Party,4208,0,4208,8
Haryana,Sirsa,SANJIV BHOJRAJ,Vanchitsamaj Insaaf Party,2350,0,2350,9
Haryana,Sirsa,HANSRAJ HANSA,JM,2901,0,2901,10
Haryana,Sirsa,JAGDISH,Independent,2145,0,2145,11
Haryana,Sirsa,JAIPAL BHATTI,Independent,1365,0,1365,12
Haryana,Sirsa,FAKIR CHAND,Independent,1197,0,1197,13
Haryana,Sirsa,MANJEET SINGH,Independent,1334,0,1334,14
Haryana,Sirsa,MEWA SINGH,Independent,4136,0,4136,15
Haryana,Sirsa,RANVIR KHOBRA,Independent,7308,0,7308,16
Haryana,Sirsa,RAJBIR PALNA,Independent,5636,0,5636,17
Haryana,Sirsa,SURENDER KUMAR (URF) MENPAL PHOOLA,Independent,3432,0,3432,18
Haryana,Sirsa,None of the Above,NOTA,4031,2,4033,19
Haryana,Hisar,KULDEEP BISHNOI,HJCBL,462219,412,462631,1
Haryana,Hisar,DUSHYANT CHAUTALA,Indian National Lok Dal,494213,265,494478,2
Haryana,Hisar,PHUL SINGH,Communist Party of India  (Marxist),6531,2,6533,3
Haryana,Hisar,MANGE RAM,Bahujan Samaj Party,30437,9,30446,4
Haryana,Hisar,SAMPAT SINGH,Indian National Congress,102491,18,102509,5
Haryana,Hisar,OM PARKASH,BhSMP,1464,7,1471,6
Haryana,Hisar,KULDEEP SINGH S/O SHISHPAL,Bahujan Mukti Party,705,0,705,7
Haryana,Hisar,MAMTA RANI,RPP(LB),1195,0,1195,8
Haryana,Hisar,DR. YUDHBIR SINGH KHYALIA,Aam Aadmi Party,28462,28,28490,9
Haryana,Hisar,ARUN KUMAR,Independent,307,0,307,10
Haryana,Hisar,ATAM PARKASH,Independent,300,0,300,11
Haryana,Hisar,UMED SINGH,Independent,342,0,342,12
Haryana,Hisar,KARTAR SINGH,Independent,1143,0,1143,13
Haryana,Hisar,KULDEEP S/O ISHWAR SINGH,Independent,1242,0,1242,14
Haryana,Hisar,KULDEEP S/O KARAN SINGH,Independent,1886,0,1886,15
Haryana,Hisar,KULDEEP S/O NARAIN SINGH,Independent,5251,0,5251,16
Haryana,Hisar,KULDEEP S/O PARDUMN,Independent,2587,0,2587,17
Haryana,Hisar,KULDEEP S/O MADAN LAL,Independent,959,0,959,18
Haryana,Hisar,KULDEEP S/O SAJJAN,Independent,395,0,395,19
Haryana,Hisar,NARINDER KUMAR,Independent,388,0,388,20
Haryana,Hisar,NARENDER,Independent,408,0,408,21
Haryana,Hisar,NARESH BATRA,Independent,587,0,587,22
Haryana,Hisar,BALJEET,Independent,208,0,208,23
Haryana,Hisar,BALWAN SINGH,Independent,213,0,213,24
Haryana,Hisar,YUDHVIR,Independent,197,0,197,25
Haryana,Hisar,RAKESH KUMAR (RINKU BHAI),Independent,176,0,176,26
Haryana,Hisar,RAJ KUMAR,Independent,255,0,255,27
Haryana,Hisar,RAJ SINGH,Independent,600,0,600,28
Haryana,Hisar,DR. RAJESH MAHENDIA,Independent,1723,0,1723,29
Haryana,Hisar,RAM PHAL,Independent,463,0,463,30
Haryana,Hisar,VIKAS,Independent,684,0,684,31
Haryana,Hisar,VIJAY KUMAR SHARMA,Independent,1788,0,1788,32
Haryana,Hisar,VISHNU KUMAR,Independent,1048,0,1048,33
Haryana,Hisar,SHIV KUMAR,Independent,446,1,447,34
Haryana,Hisar,SHRAVAN KUMAR ASIJA,Independent,371,0,371,35
Haryana,Hisar,SATBIR,Independent,363,0,363,36
Haryana,Hisar,SITA RAM,Independent,127,1,128,37
Haryana,Hisar,SUNDER,Independent,134,0,134,38
Haryana,Hisar,SUSHIL KAUSHIK,Independent,700,0,700,39
Haryana,Hisar,SUSHIL NIDHI,Independent,273,0,273,40
Haryana,Hisar,HANSRAJ,Independent,245,0,245,41
Haryana,Hisar,None of the Above,NOTA,1643,2,1645,42
Haryana,Karnal,ARVIND KUMAR SHARMA,Indian National Congress,234657,13,234670,1
Haryana,Karnal,ASHWINI KUMAR,Bharatiya Janata Party,594704,113,594817,2
Haryana,Karnal,JASWINDER SINGH SANDHU,Indian National Lok Dal,187893,9,187902,3
Haryana,Karnal,MAM CHAND,Communist Party of India,10945,0,10945,4
Haryana,Karnal,MARATHA VIRENDER VERMA,Bahujan Samaj Party,102624,4,102628,5
Haryana,Karnal,ASHISH,All India Forward Bloc,1314,0,1314,6
Haryana,Karnal,KHATAB SINGH MOR,Bhartiya Shakti Chetna Party,885,0,885,7
Haryana,Karnal,DULI CHAND,LPR,1144,0,1144,8
Haryana,Karnal,DEVENDER JAGLAN,Republican Party of India (A),759,0,759,9
Haryana,Karnal,DAVINDER SHARMA,RAKP,806,0,806,10
Haryana,Karnal,PARAMJIT SINGH,Aam Aadmi Party,32057,3,32060,11
Haryana,Karnal,PALE RAM KASHYAP,RJP(E),2654,0,2654,12
Haryana,Karnal,PURAN SINGH PANWAR,Rashtravadi Janata Party,865,0,865,13
Haryana,Karnal,ARVIND TIWARI,Independent,1260,0,1260,14
Haryana,Karnal,KISMAT SHARMA,Independent,1757,0,1757,15
Haryana,Karnal,JAGDISH,Independent,3442,0,3442,16
Haryana,Karnal,JAGBIR SINGH RANA,Independent,2775,0,2775,17
Haryana,Karnal,MAHMOOD HASSAN,Independent,2723,0,2723,18
Haryana,Karnal,MAHINDER PAL,Independent,1276,0,1276,19
Haryana,Karnal,RAJESH KUMAR,Independent,1937,0,1937,20
Haryana,Karnal,RAMPHAL SHARMA,Independent,940,0,940,21
Haryana,Karnal,SHASHI SAINI,Independent,1544,0,1544,22
Haryana,Karnal,SAVITRI,Independent,1468,0,1468,23
Haryana,Karnal,None of the Above,NOTA,2929,0,2929,24
Haryana,Sonipat,JAGBIR SINGH MALIK,Indian National Congress,269727,62,269789,1
Haryana,Sonipat,PADAM SINGH,Indian National Lok Dal,264284,120,264404,2
Haryana,Sonipat,RAMESH CHANDER,Bharatiya Janata Party,346979,224,347203,3
Haryana,Sonipat,SUMAN SINGH,Bahujan Samaj Party,24102,1,24103,4
Haryana,Sonipat,ANIL KUMAR,Rashtriya Bahujan Hitay Party,468,0,468,5
Haryana,Sonipat,ANUP SING DAHIYA,RJAVP,259,0,259,6
Haryana,Sonipat,ASHOK KUMAR VASHISHTH,Republican Party of India (A),492,0,492,7
Haryana,Sonipat,GULAB SINGH,PHRC,916,0,916,8
Haryana,Sonipat,JAI SINGH,Aam Aadmi Party,48565,32,48597,9
Haryana,Sonipat,DALBIR SINGH CHAHAL,Rashtravadi Janata Party,671,0,671,10
Haryana,Sonipat,HARI PARKASH COMRADE,SOCIALIST UNITY CENTRE OF INDIA (COMMUNIST),1757,0,1757,11
Haryana,Sonipat,JAGBIR,Independent,357,0,357,12
Haryana,Sonipat,JASWANT,Independent,656,0,656,13
Haryana,Sonipat,PADAM SINGH,Independent,1375,0,1375,14
Haryana,Sonipat,BIJENDER KUMAR,Independent,965,0,965,15
Haryana,Sonipat,BHUPESHWAR DAYAL,Independent,2524,1,2525,16
Haryana,Sonipat,MANOJ KUMAR,Independent,2417,0,2417,17
Haryana,Sonipat,RAMESH,Independent,4405,0,4405,18
Haryana,Sonipat,SANJAY,Independent,3950,0,3950,19
Haryana,Sonipat,SANT DHARAMVIR CHOTIWALA,Independent,943,0,943,20
Haryana,Sonipat,SATYA NARAYAN,Independent,550,0,550,21
Haryana,Sonipat,SITENDER SINGH,Independent,899,0,899,22
Haryana,Sonipat,SUKHBIR SINGH,Independent,5534,0,5534,23
Haryana,Sonipat,None of the Above,NOTA,2401,2,2403,24
Haryana,Rohtak,OM PARKASH DHANKAR,Bharatiya Janata Party,318984,452,319436,1
Haryana,Rohtak,DEEPENDER SINGH HOODA,Indian National Congress,489900,163,490063,2
Haryana,Rohtak,MANOJ KUMAR,Bahujan Samaj Party,18682,8,18690,3
Haryana,Rohtak,SHAMSHER SINGH KHARKARA,Indian National Lok Dal,151085,35,151120,4
Haryana,Rohtak,ANIL,Rashtriya Bahujan Hitay Party,828,1,829,5
Haryana,Rohtak,JAI KARAN MANDAUTHI,SOCIALIST UNITY CENTRE OF INDIA (COMMUNIST),2497,0,2497,6
Haryana,Rohtak,NAVEEN JAIHIND,Aam Aadmi Party,46739,20,46759,7
Haryana,Rohtak,RAVINDER KUMAR,IBSPK,418,0,418,8
Haryana,Rohtak,SUNIL KUMAR,All India Trinamool Congress,947,0,947,9
Haryana,Rohtak,KARAN SINGH,Independent,394,0,394,10
Haryana,Rohtak,JAI SINGH,Independent,614,0,614,11
Haryana,Rohtak,VISHNU DUTT,Independent,3151,0,3151,12
Haryana,Rohtak,SAJJAN SINGH,Independent,2032,0,2032,13
Haryana,Rohtak,SATPAL,Independent,2449,0,2449,14
Haryana,Rohtak,None of the Above,NOTA,4931,1,4932,15
Haryana,Bhiwani-Mahendragarh,DHARAMBIR S/O BHALE RAM,Bharatiya Janata Party,404065,477,404542,1
Haryana,Bhiwani-Mahendragarh,BAHADUR SINGH,Indian National Lok Dal,275062,86,275148,2
Haryana,Bhiwani-Mahendragarh,VED PAL TANWAR,Bahujan Samaj Party,27823,11,27834,3
Haryana,Bhiwani-Mahendragarh,MASTER SHER SINGH,Communist Party of India  (Marxist),3439,2,3441,4
Haryana,Bhiwani-Mahendragarh,SHRUTI CHOUDHRY,Indian National Congress,268007,108,268115,5
Haryana,Bhiwani-Mahendragarh,OMBIR,LPR,1617,0,1617,6
Haryana,Bhiwani-Mahendragarh,NARESH KUMAR,Samajwadi Party,1493,0,1493,7
Haryana,Bhiwani-Mahendragarh,RAJIV,Bahujan Mukti Party,603,0,603,8
Haryana,Bhiwani-Mahendragarh,LALIT AGGARWAL,Aam Aadmi Party,22172,28,22200,9
Haryana,Bhiwani-Mahendragarh,LAL CHAND,Republican Backward Congress,6265,0,6265,10
Haryana,Bhiwani-Mahendragarh,SAMSER,National Loktantrik Party,391,0,391,11
Haryana,Bhiwani-Mahendragarh,CHITTER SINGH BALI,Independent,1060,0,1060,12
Haryana,Bhiwani-Mahendragarh,DHARAMBIR S/O BANWARI,Independent,708,0,708,13
Haryana,Bhiwani-Mahendragarh,DHARM BIR S/O HARI SINGH,Independent,995,0,995,14
Haryana,Bhiwani-Mahendragarh,DHARAMBIR SINGH,Independent,2357,0,2357,15
Haryana,Bhiwani-Mahendragarh,NARENDER PICHOPA-KHURD,Independent,3151,0,3151,16
Haryana,Bhiwani-Mahendragarh,PURAN MAL SHARMA,Independent,3195,0,3195,17
Haryana,Bhiwani-Mahendragarh,PARDEEP SINGH TANWAR,Independent,1334,0,1334,18
Haryana,Bhiwani-Mahendragarh,MAHAVIR SINGH,Independent,393,0,393,19
Haryana,Bhiwani-Mahendragarh,RAKESH KUMAR,Independent,292,1,293,20
Haryana,Bhiwani-Mahendragarh,VEDPARKASH BHARTIYA,Independent,1020,0,1020,21
Haryana,Bhiwani-Mahendragarh,SHER SINGH,Independent,361,0,361,22
Haryana,Bhiwani-Mahendragarh,SATPAL S/O LOKRAM,Independent,296,1,297,23
Haryana,Bhiwani-Mahendragarh,SATPAL S/O SUBE,Independent,826,0,826,24
Haryana,Bhiwani-Mahendragarh,SUKHBIR SINGH,Independent,275,0,275,25
Haryana,Bhiwani-Mahendragarh,SUDHIR CHANDWAS,Independent,523,0,523,26
Haryana,Bhiwani-Mahendragarh,None of the Above,NOTA,1994,0,1994,27
Haryana,Gurgaon,INDERJIT SINGH RAO,Bharatiya Janata Party,644486,294,644780,1
Haryana,Gurgaon,ZAKIR HUSSAIN,Indian National Lok Dal,370052,6,370058,2
Haryana,Gurgaon,DHARAMPAL,Bahujan Samaj Party,65007,2,65009,3
Haryana,Gurgaon,RAO DHARAM PAL,Indian National Congress,133697,16,133713,4
Haryana,Gurgaon,AKBAR KASMI,Rashtriya Ulama Council,1429,0,1429,5
Haryana,Gurgaon,ASHOK BHARDWAJ,NAJC,713,0,713,6
Haryana,Gurgaon,UMED SINGH,RMOP,923,0,923,7
Haryana,Gurgaon,YOGENDRA YADAV,Aam Aadmi Party,79442,14,79456,8
Haryana,Gurgaon,HEMANT KUMAR SAINI,Bahujan Mukti Party,1153,0,1153,9
Haryana,Gurgaon,ABDUL LATIF,Independent,699,0,699,10
Haryana,Gurgaon,AHSHAN ALI,Independent,455,0,455,11
Haryana,Gurgaon,USHA RANI VERMA,Independent,489,0,489,12
Haryana,Gurgaon,OMBIR SHARMA,Independent,566,0,566,13
Haryana,Gurgaon,KARAN SINGH JOURNALIST,Independent,938,0,938,14
Haryana,Gurgaon,KUSHESHWAR BHAGAT,Independent,7821,0,7821,15
Haryana,Gurgaon,FAUJI JAI KAWAR TYAGI DIXIT,Independent,3147,0,3147,16
Haryana,Gurgaon,MANOJ YADAV,Independent,3043,0,3043,17
Haryana,Gurgaon,MAHENDER JAT,Independent,1021,0,1021,18
Haryana,Gurgaon,MUL CHAND,Independent,804,0,804,19
Haryana,Gurgaon,RAJEEV YADAV,Independent,494,0,494,20
Haryana,Gurgaon,RAJESH,Independent,565,1,566,21
Haryana,Gurgaon,SURINDER KUMAR KHULLAR,Independent,685,0,685,22
Haryana,Gurgaon,None of the Above,NOTA,2658,0,2658,23
Haryana,Faridabad,AVTAR SINGH BHADANA,Indian National Congress,185642,1,185643,1
Haryana,Faridabad,R K ANAND,Indian National Lok Dal,132465,7,132472,2
Haryana,Faridabad,KRISHAN PAL,Bharatiya Janata Party,652472,44,652516,3
Haryana,Faridabad,PT. RAJENDER SHARMA,Bahujan Samaj Party,66000,0,66000,4
Haryana,Faridabad,ADVOCATE KAMAL CHAND ARYA,Bahujan Mukti Party,967,0,967,5
Haryana,Faridabad,KUSUM KUMARI,AIPF,620,0,620,6
Haryana,Faridabad,KHUSH DIL SEHGAL (KAPOOR),ABHKP,685,0,685,7
Haryana,Faridabad,KHEME THAKUR,Samajwadi Party,1940,0,1940,8
Haryana,Faridabad,CHAUDHARY DAYA CHAND,Bhartiya Shakti Chetna Party,711,0,711,9
Haryana,Faridabad,DEEPAK GAUR,AVIRP,479,0,479,10
Haryana,Faridabad,NIRMALA,Janata Dal (United),976,0,976,11
Haryana,Faridabad,PURSHOTAM DAGAR,Aam Aadmi Party,67353,2,67355,12
Haryana,Faridabad,MOHD. MUKIM,National Loktantrik Party,1735,0,1735,13
Haryana,Faridabad,RAVINDER BHATI,Akhil Bharat Hindu Mahasabha,1689,0,1689,14
Haryana,Faridabad,SUKHVEER,Rashtriya Bahujan Congress Party,1084,0,1084,15
Haryana,Faridabad,HAMID KHAN,hkd,2761,0,2761,16
Haryana,Faridabad,DR. KSHETRA PAL SINGH,Independent,1942,0,1942,17
Haryana,Faridabad,AHERWAN DHARMENDER RAWAT,Independent,665,0,665,18
Haryana,Faridabad,NANAK CHAND,Independent,2550,0,2550,19
Haryana,Faridabad,MANDHEER SINGH MAAN,Independent,644,0,644,20
Haryana,Faridabad,MUKESH KUMAR SINGH,Independent,442,0,442,21
Haryana,Faridabad,RAJENDER,Independent,410,0,410,22
Haryana,Faridabad,LAXMAN,Independent,656,0,656,23
Haryana,Faridabad,LALIT MITTAL,Independent,420,0,420,24
Haryana,Faridabad,VIJAY RAJ,Independent,407,0,407,25
Haryana,Faridabad,SHUSHILA,Independent,524,0,524,26
Haryana,Faridabad,SANJAY MAURYA,Independent,1104,0,1104,27
Haryana,Faridabad,None of the Above,NOTA,3328,0,3328,28
Himachal Pradesh,Kangra,CHANDER KUMAR,Indian National Congress,285694,397,286091,1
Himachal Pradesh,Kangra,LAL HUSSAIN,Bahujan Samaj Party,5947,2,5949,2
Himachal Pradesh,Kangra,SHANTA KUMAR,Bharatiya Janata Party,455160,1003,456163,3
Himachal Pradesh,Kangra,ARTI SONI,Shivsena,3757,0,3757,4
Himachal Pradesh,Kangra,PARVESH YADAV,Samajwadi Party,808,0,808,5
Himachal Pradesh,Kangra,RAMAN KUMAR,Bahujan Mukti Party,637,0,637,6
Himachal Pradesh,Kangra,DR. RAJAN SUSHANT,Aam Aadmi Party,24390,40,24430,7
Himachal Pradesh,Kangra,BALDEV RAJ,HiSP,995,2,997,8
Himachal Pradesh,Kangra,DR. ATUL THAKUR BHARMORI,Independent,1132,1,1133,9
Himachal Pradesh,Kangra,DHANI RAM,Independent,1084,1,1085,10
Himachal Pradesh,Kangra,PREM CHAND VISHVAKARMA,Independent,4104,2,4106,11
Himachal Pradesh,Kangra,BHUPINDER MEHRA,Independent,5585,0,5585,12
Himachal Pradesh,Kangra,None of the Above,NOTA,8696,8,8704,13
Himachal Pradesh,Mandi,KUSHAL BHARDWAJ,Communist Party of India  (Marxist),13955,10,13965,1
Himachal Pradesh,Mandi,PRATIBHA SINGH,Indian National Congress,322465,503,322968,2
Himachal Pradesh,Mandi,RAM SWAROOP SHARMA,Bharatiya Janata Party,362338,486,362824,3
Himachal Pradesh,Mandi,LALA RAM,Bahujan Samaj Party,5163,4,5167,4
Himachal Pradesh,Mandi,JAI CHAND THAKUR,Aam Aadmi Party,9345,14,9359,5
Himachal Pradesh,Mandi,DEVENDER DEV,Bahujan Mukti Party,901,0,901,6
Himachal Pradesh,Mandi,PUNI CHAND,Samajwadi Party,923,0,923,7
Himachal Pradesh,Mandi,BHAG CHAND RANA,Independent,1868,0,1868,8
Himachal Pradesh,Mandi,SUBHASH MOHAN SNEHI,Independent,1928,0,1928,9
Himachal Pradesh,Mandi,None of the Above,NOTA,6184,7,6191,10
Himachal Pradesh,Hamirpur,ANURAG SINGH THAKUR,Bharatiya Janata Party,446755,1280,448035,1
Himachal Pradesh,Hamirpur,RAKESH CHOUDHARY,Bahujan Samaj Party,5821,6,5827,2
Himachal Pradesh,Hamirpur,RAJINDER SINGH RANA,Indian National Congress,348871,761,349632,3
Himachal Pradesh,Hamirpur,URMILA SHARMA,Samajwadi Party,2327,1,2328,4
Himachal Pradesh,Hamirpur,KAMAL KANTA BATRA,Aam Aadmi Party,15281,48,15329,5
Himachal Pradesh,Hamirpur,SHIV DUTT VASISHT,Shivsena,952,0,952,6
Himachal Pradesh,Hamirpur,AMIN CHAND,Independent,646,1,647,7
Himachal Pradesh,Hamirpur,ASHISH KUMAR,Independent,603,0,603,8
Himachal Pradesh,Hamirpur,DEV RAJ BHARDWAJ,Independent,1690,2,1692,9
Himachal Pradesh,Hamirpur,RAJINDER SINGH RANA,Independent,3677,10,3687,10
Himachal Pradesh,Hamirpur,None of the Above,NOTA,6464,9,6473,11
Himachal Pradesh,Shimla,GURNAM SINGH KOLI,Bahujan Samaj Party,5984,1,5985,1
Himachal Pradesh,Shimla,JAGAT RAM,Communist Party of India  (Marxist),11427,7,11434,2
Himachal Pradesh,Shimla,MOHAN LAL BRAKTA,Indian National Congress,301314,472,301786,3
Himachal Pradesh,Shimla,VIRENDER KASHYAP,Bharatiya Janata Party,385517,456,385973,4
Himachal Pradesh,Shimla,SHURVEER SINGH,Samajwadi Party,4385,0,4385,5
Himachal Pradesh,Shimla,SUBHASH CHANDER,Aam Aadmi Party,14205,28,14233,6
Himachal Pradesh,Shimla,VIRENDER KUMAR KASHYAP,Independent,6170,3,6173,7
Himachal Pradesh,Shimla,None of the Above,NOTA,7775,12,7787,8
Jammu & Kashmir,Baramulla,GHULAM MOHAMMAD MIR,Bharatiya Janata Party,6545,13,6558,1
Jammu & Kashmir,Baramulla,SYED MOHD RAFIQ SHAH,Jammu & Kashmir National Panthers Party,4141,0,4141,2
Jammu & Kashmir,Baramulla,MOHD SHAFI BHAT,Bahujan Samaj Party,3143,0,3143,3
Jammu & Kashmir,Baramulla,MUZAFFAR HUSSAIN BAIG,Jammu & Kashmir Peoples Democratic Party,175277,0,175277,4
Jammu & Kashmir,Baramulla,SHARIEF UD-DIN SHARIQ,JKN,146058,0,146058,5
Jammu & Kashmir,Baramulla,AYAZ AHMAD SOFI,GaAP,5566,0,5566,6
Jammu & Kashmir,Baramulla,BASHIR AHMAD JAGAL,Prism,2694,0,2694,7
Jammu & Kashmir,Baramulla,SALAMUDDIN BAJAD,Jammu & Kashmir People Conference,71154,0,71154,8
Jammu & Kashmir,Baramulla,TANVEER HUSSAIN,Independent,5788,0,5788,9
Jammu & Kashmir,Baramulla,ASHIQ HUSSAIN GANIE,Independent,1943,0,1943,10
Jammu & Kashmir,Baramulla,ABDUL HUSSAIN,Independent,7301,0,7301,11
Jammu & Kashmir,Baramulla,AB. HAMID MALIK,Independent,3655,0,3655,12
Jammu & Kashmir,Baramulla,ER. ABDUL RASHID SHEIKH,Independent,22090,0,22090,13
Jammu & Kashmir,Baramulla,MOHD ABDULLAH CHATWAL,Independent,4006,0,4006,14
Jammu & Kashmir,Baramulla,NISAR AHMAD AHANGER,Independent,2050,0,2050,15
Jammu & Kashmir,Baramulla,None of the Above,NOTA,4568,0,4568,16
Jammu & Kashmir,Srinagar,TARIQ HAMEED KARRA,Jammu & Kashmir Peoples Democratic Party,157923,0,157923,1
Jammu & Kashmir,Srinagar,FAROOQ ABDULLAH,JKN,115642,1,115643,2
Jammu & Kashmir,Srinagar,FAYAZ AHMAD BHAT,Bharatiya Janata Party,4465,2,4467,3
Jammu & Kashmir,Srinagar,MOHAMMAD MAQBOOL MALIK,Jammu & Kashmir National Panthers Party,583,0,583,4
Jammu & Kashmir,Srinagar,DR RAJA MUZAFFAR BHAT,Aam Aadmi Party,3271,0,3271,5
Jammu & Kashmir,Srinagar,MUSHTAQ SHAMIM,ABML(S),521,0,521,6
Jammu & Kashmir,Srinagar,AGA SYED MOHSIN,Independent,16049,1,16050,7
Jammu & Kashmir,Srinagar,BASHIR MOHD RESHI,Independent,1215,0,1215,8
Jammu & Kashmir,Srinagar,CHETAN SHARMA,Independent,608,0,608,9
Jammu & Kashmir,Srinagar,RABIA ALTAF,Independent,864,0,864,10
Jammu & Kashmir,Srinagar,RIYAZ AHMAD WANI,Independent,461,0,461,11
Jammu & Kashmir,Srinagar,ABDUL RASHID TANTRAY,Independent,1668,0,1668,12
Jammu & Kashmir,Srinagar,MOHAMMAD SHAFI GUROO,Independent,1157,0,1157,13
Jammu & Kashmir,Srinagar,MIRZA SAJAD HUSSAIN BEIGH,Independent,2802,0,2802,14
Jammu & Kashmir,Srinagar,None of the Above,NOTA,4979,0,4979,15
Jammu & Kashmir,Anantnag,SYED ABID AHMAD SHAH,Jammu & Kashmir National Panthers Party,4345,0,4345,1
Jammu & Kashmir,Anantnag,MIRZA MEHBOOB BEG,JKN,135005,7,135012,2
Jammu & Kashmir,Anantnag,MEHBOOBA MUFTI,Jammu & Kashmir Peoples Democratic Party,200407,22,200429,3
Jammu & Kashmir,Anantnag,MOHAMMAD SHARIF,Bahujan Samaj Party,3312,0,3312,4
Jammu & Kashmir,Anantnag,MUSHTAQ AHMAD MALIK,Bharatiya Janata Party,4710,10,4720,5
Jammu & Kashmir,Anantnag,ASIF JEELANI,All India Forward Bloc,803,0,803,6
Jammu & Kashmir,Anantnag,DR. TANVIR MAQBOOL DAR,Aam Aadmi Party,3251,1,3252,7
Jammu & Kashmir,Anantnag,GH. NABI SHAH,Samajwadi Party,1837,0,1837,8
Jammu & Kashmir,Anantnag,MOHAMMAD YAQOOB RATHER,AKAKRP,1568,0,1568,9
Jammu & Kashmir,Anantnag,MOHD YOUSIF  GANIE,Ambedkar Samaj Party,3285,1,3286,10
Jammu & Kashmir,Anantnag,TANVEER HUSSAIN KHAN,Independent,7340,0,7340,11
Jammu & Kashmir,Anantnag,ABDUL AHAD MIR,Independent,3439,0,3439,12
Jammu & Kashmir,Anantnag,None of the Above,NOTA,5936,0,5936,13
Jammu & Kashmir,Ladakh,THUPSTAN CHHEWANG,Bharatiya Janata Party,30731,380,31111,1
Jammu & Kashmir,Ladakh,TSERING SAMPHEL,Indian National Congress,25985,417,26402,2
Jammu & Kashmir,Ladakh,SYED MOHD KAZIM,Independent,28197,37,28234,3
Jammu & Kashmir,Ladakh,GHULAM RAZA,Independent,31049,26,31075,4
Jammu & Kashmir,Ladakh,None of the Above,NOTA,1202,5,1207,5
Jammu & Kashmir,Udhampur,PROF. BHIM SINGH,Jammu & Kashmir National Panthers Party,25304,8,25312,1
Jammu & Kashmir,Udhampur,DR. JITENDRA SINGH,Bharatiya Janata Party,486820,549,487369,2
Jammu & Kashmir,Udhampur,DHARAM PAL BALGOTRA,Bahujan Samaj Party,16433,4,16437,3
Jammu & Kashmir,Udhampur,GHULAM NABI AZAD,Indian National Congress,426336,57,426393,4
Jammu & Kashmir,Udhampur,MOHD ARSHAD MALIK,Jammu & Kashmir Peoples Democratic Party,30458,3,30461,5
Jammu & Kashmir,Udhampur,SMT. AMRIT BARSHA,Samajwadi Party,1842,0,1842,6
Jammu & Kashmir,Udhampur,JAGDISH KUMAR,Jai Maha Bharath Party,1809,0,1809,7
Jammu & Kashmir,Udhampur,SHAM LAL,AJKMP,2185,2,2187,8
Jammu & Kashmir,Udhampur,GIRDHARI LAL,BHBP,1967,4,1971,9
Jammu & Kashmir,Udhampur,ANIL KUMAR GUPTA,Independent,5755,0,5755,10
Jammu & Kashmir,Udhampur,ANIL KHAJURIA,Independent,15188,0,15188,11
Jammu & Kashmir,Udhampur,BANSI LAL,Independent,7339,0,7339,12
Jammu & Kashmir,Udhampur,NAZAKAT HUSSAIN,Independent,9217,0,9217,13
Jammu & Kashmir,Udhampur,None of the Above,NOTA,10477,1,10478,14
Jammu & Kashmir,Jammu,ASHOK KUMAR,Bahujan Samaj Party,31194,5,31199,1
Jammu & Kashmir,Jammu,JUGAL KISHORE,Bharatiya Janata Party,618245,1750,619995,2
Jammu & Kashmir,Jammu,MADAN LAL SHARMA,Indian National Congress,362537,178,362715,3
Jammu & Kashmir,Jammu,HARI CHAND JALMERIA,Jammu & Kashmir National Panthers Party,9067,4,9071,4
Jammu & Kashmir,Jammu,YASHPAL SHARMA,Jammu & Kashmir Peoples Democratic Party,168451,103,168554,5
Jammu & Kashmir,Jammu,BAHADUR SINGH CHOWDHARY,Samajwadi Party,3163,1,3164,6
Jammu & Kashmir,Jammu,SUBASH CHANDER,AJKMP,2201,4,2205,7
Jammu & Kashmir,Jammu,GURSAGAR SINGH,SDP,6042,0,6042,8
Jammu & Kashmir,Jammu,MEHAR MANAV BHAGAT,BHBP,2013,0,2013,9
Jammu & Kashmir,Jammu,ASHOK KUMAR SHARMA,Independent,2582,0,2582,10
Jammu & Kashmir,Jammu,PERSEEN SINGH,Independent,7173,0,7173,11
Jammu & Kashmir,Jammu,RAJ KUMAR,Independent,2989,2,2991,12
Jammu & Kashmir,Jammu,SATISH POONCHI,Independent,1974,7,1981,13
Jammu & Kashmir,Jammu,ABDUL MAJID CHOUHAN,Independent,4176,1,4177,14
Jammu & Kashmir,Jammu,LABHA RAM,Independent,5042,4,5046,15
Jammu & Kashmir,Jammu,MOHD. IMTIAZ,Independent,7422,1,7423,16
Jammu & Kashmir,Jammu,MOHD. ABBAS KHAN,Independent,2469,0,2469,17
Jammu & Kashmir,Jammu,NIRMAL SINGH,Independent,5283,3,5286,18
Jammu & Kashmir,Jammu,VIJAY KUMAR,Independent,5125,0,5125,19
Jammu & Kashmir,Jammu,None of the Above,NOTA,4381,1,4382,20
Karnataka,Chikkodi,KATTI RAMESH VISHWANATH,Bharatiya Janata Party,471029,341,471370,1
Karnataka,Chikkodi,KADAPURE MACHINDRA DAVALU,Bahujan Samaj Party,14484,9,14493,2
Karnataka,Chikkodi,PRAKASH BABANNA HUKKERI,Indian National Congress,474301,72,474373,3
Karnataka,Chikkodi,PRATAPARAO  PATIL,Nationalist Congress Party,42735,3,42738,4
Karnataka,Chikkodi,SHRIMANT BALASAHEB PATIL,Janata Dal (Secular),39991,1,39992,5
Karnataka,Chikkodi,APPASAHEB SRIPATHI KURANE,SJPA,1457,0,1457,6
Karnataka,Chikkodi,ASHFAQ AHMED MADAKI,Aam Aadmi Party,3521,8,3529,7
Karnataka,Chikkodi,JITENDRA SUBHASH NERLE,Independent,1414,0,1414,8
Karnataka,Chikkodi,BASAPPA KALLAPPA HANCHANAL,Independent,1744,0,1744,9
Karnataka,Chikkodi,MAGADUM GOUSMOHIUDDIN ISMAIL MAGDUM,Independent,2624,0,2624,10
Karnataka,Chikkodi,MOHAN GURAPPA MOTANNAVAR,Independent,3457,1,3458,11
Karnataka,Chikkodi,SHRINIK ANNASAHEB JANGATE,Independent,3622,0,3622,12
Karnataka,Chikkodi,None of the Above,NOTA,10289,0,10289,13
Karnataka,Belgaum,ANGADI SURESH CHANNABASAPPA,Bharatiya Janata Party,553802,615,554417,1
Karnataka,Belgaum,BAGWAN NASIR PAPULSAB,Janata Dal (Secular),5477,0,5477,2
Karnataka,Belgaum,RAMESH G KADALASKAR,Bahujan Samaj Party,3534,1,3535,3
Karnataka,Belgaum,LAXMI R. HEBBALKAR,Indian National Congress,478374,183,478557,4
Karnataka,Belgaum,ANGADI MUTTAPPA CHANNASANGAPPA,Aam Aadmi Party,8513,11,8524,5
Karnataka,Belgaum,DAYANAND GURUPUTRAYYA CHIKKAMATH,Samajwadi Party,1261,0,1261,6
Karnataka,Belgaum,ANTAKKANAVAR PARAPPA SHANKAREPPA,Independent,775,0,775,7
Karnataka,Belgaum,KHANAGOUDAR S B,Independent,920,0,920,8
Karnataka,Belgaum,DR. GAONKAR RAJMAHENDRA SAKHARAM,Independent,781,0,781,9
Karnataka,Belgaum,MAJUKAR HANMANT KRISHANA,Independent,1187,0,1187,10
Karnataka,Belgaum,MOHAN YALLAPPA MORE,Independent,1458,0,1458,11
Karnataka,Belgaum,S. P. RATHOD,Independent,1757,0,1757,12
Karnataka,Belgaum,RAMAPPA (RAMCHANDRA) MAREPPA CHALAWADI,Independent,3468,0,3468,13
Karnataka,Belgaum,SANTOSH MANOHAR BAVADEKAR,Independent,1656,0,1656,14
Karnataka,Belgaum,SANTOSH M. SHET @ RAIKAR,Independent,3246,0,3246,15
Karnataka,Belgaum,None of the Above,NOTA,11507,2,11509,16
Karnataka,Bagalkot,AJAY KUMAR SARNAIK,Indian National Congress,454846,142,454988,1
Karnataka,Bagalkot,Y.C KAMBLE,Bahujan Samaj Party,7370,0,7370,2
Karnataka,Bagalkot,GADDIGOUDAR PARVTAGOUDA CHANDANAGOUDA,Bharatiya Janata Party,571200,348,571548,3
Karnataka,Bagalkot,HUNASHYAL RAVI,Janata Dal (Secular),7236,1,7237,4
Karnataka,Bagalkot,KANABUR SADASHIV SIDAMALLAPPA,Janata Dal (United),1180,0,1180,5
Karnataka,Bagalkot,KAZI KUTUBUDDIN,Aam Aadmi Party,2000,4,2004,6
Karnataka,Bagalkot,MAHESH BASAPPA NANDIHAL,KAP,813,0,813,7
Karnataka,Bagalkot,AJJODI BHEEMAPPA DHOOLAPPA,Independent,993,1,994,8
Karnataka,Bagalkot,NAGAPPA PAKKIRAPPA SHIRAGUPPI,Independent,1194,0,1194,9
Karnataka,Bagalkot,PARASHURAM MANASING RATHOD,Independent,3897,0,3897,10
Karnataka,Bagalkot,MUTTAPPA MUDAKAPPA HIREKUMBI,Independent,2037,0,2037,11
Karnataka,Bagalkot,VASANAGOUDA NINGANAGOUDA BHANDI,Independent,4325,0,4325,12
Karnataka,Bagalkot,SHANKAR BIDARI,Independent,10950,9,10959,13
Karnataka,Bagalkot,None of the Above,NOTA,10764,0,10764,14
Karnataka,Bijapur,PRAKASH RATHOD,Indian National Congress,401936,2,401938,1
Karnataka,Bijapur,RAMESH JIGAJINAGI,Bharatiya Janata Party,471738,19,471757,2
Karnataka,Bijapur,K SHIVRAM,Janata Dal (Secular),57550,1,57551,3
Karnataka,Bijapur,SUDHAKAR KANAMADI,Bahujan Samaj Party,2818,0,2818,4
Karnataka,Bijapur,BHAGWAN DHARMANNA KAMBALE,Republican Party of India (A),1340,0,1340,5
Karnataka,Bijapur,SHRIKANT DEVENDRAPPA ARAKERI,KAP,1930,0,1930,6
Karnataka,Bijapur,SHRIDHAR NARAYANKAR,Aam Aadmi Party,4716,1,4717,7
Karnataka,Bijapur,RAVI (RAJESH) Y VALLYAPUR,Independent,1283,0,1283,8
Karnataka,Bijapur,RAJU SHRIMANT PADAGANUR,Independent,1422,0,1422,9
Karnataka,Bijapur,RUDRESH DAYAPPA DODAMANI,Independent,2259,0,2259,10
Karnataka,Bijapur,SATISH ASANGIHAL,Independent,2194,0,2194,11
Karnataka,Bijapur,SIDDAPPA B GANJI,Independent,2691,0,2691,12
Karnataka,Bijapur,HANMANT MOTHER-BASALINGAVVA HOLER,Independent,2775,0,2775,13
Karnataka,Bijapur,HUNNUR MARAGANNA MALAPPA,Independent,3795,0,3795,14
Karnataka,Bijapur,None of the Above,NOTA,8287,0,8287,15
Karnataka,Gulbarga,D.G. SAGAR,Janata Dal (Secular),15688,2,15690,1
Karnataka,Gulbarga,MALLIKARJUN KHARGE,Indian National Congress,506975,218,507193,2
Karnataka,Gulbarga,DANNI MAHADEV B.,Bahujan Samaj Party,11426,2,11428,3
Karnataka,Gulbarga,REVUNAIK BELAMAGI,Bharatiya Janata Party,432175,285,432460,4
Karnataka,Gulbarga,B.T.LALITHA NAIK,Aam Aadmi Party,9070,4,9074,5
Karnataka,Gulbarga,S.M. SHARMA,SOCIALIST UNITY CENTRE OF INDIA (COMMUNIST),4942,1,4943,6
Karnataka,Gulbarga,SHANKAR JADHAV,BHPP,2877,0,2877,7
Karnataka,Gulbarga,RAMU,Independent,4085,0,4085,8
Karnataka,Gulbarga,None of the Above,NOTA,9887,1,9888,9
Karnataka,Raichur,D.B.NAYAK,Janata Dal (Secular),21701,5,21706,1
Karnataka,Raichur,B.V.NAYAK,Indian National Congress,443533,126,443659,2
Karnataka,Raichur,RAJA THIMAPPA NAYAK,Bahujan Samaj Party,12252,2,12254,3
Karnataka,Raichur,ARAKERA SHIVANAGOUDA NAYAK,Bharatiya Janata Party,441926,234,442160,4
Karnataka,Raichur,M NAGARAJ,Communist Party of India (Marxist),6938,0,6938,5
Karnataka,Raichur,BHAGAVANTAPPA,Lok Seva Parishad,2881,0,2881,6
Karnataka,Raichur,BHIMARAYA JARADABANDI,Aam Aadmi Party,4232,2,4234,7
Karnataka,Raichur,MARUTI,NDEP,3618,0,3618,8
Karnataka,Raichur,RANGANAYAK,Pyramid Party of India,4934,1,4935,9
Karnataka,Raichur,K SOMASHEKAR YADGIRI,SOCIALIST UNITY CENTRE OF INDIA (COMMUNIST),6788,0,6788,10
Karnataka,Raichur,CHINNAYYA NAYAK,Independent,6540,0,6540,11
Karnataka,Raichur,None of the Above,NOTA,13170,6,13176,12
Karnataka,Bidar,N. DHARAM SINGH,Indian National Congress,366991,77,367068,1
Karnataka,Bidar,BANDEPPA KHASHEMPUR,Janata Dal (Secular),58716,12,58728,2
Karnataka,Bidar,BHAGWANTH KHUBA,Bharatiya Janata Party,459044,246,459290,3
Karnataka,Bidar,SHANKAR BHAYYA,Bahujan Samaj Party,15076,3,15079,4
Karnataka,Bidar,ABDUL HAMEED FARAAN,Welfare Party of India,3747,0,3747,5
Karnataka,Bidar,GOVIND,Samajwadi Party,1427,0,1427,6
Karnataka,Bidar,CHANDRAKANT,Aam Aadmi Party,4540,0,4540,7
Karnataka,Bidar,RAMESH GAYKAWAD,ANC,1976,0,1976,8
Karnataka,Bidar,RAMANNA,Hindustan Janta Party,1378,0,1378,9
Karnataka,Bidar,SHRAVANA S.BHANDE MUNGANAL,RSPS,2862,0,2862,10
Karnataka,Bidar,SYED WAHEED,Bahujan Mukti Party,1302,0,1302,11
Karnataka,Bidar,HATTARKI YASHWANTHRAO SHIVARAYA,BHPP,1414,0,1414,12
Karnataka,Bidar,ISMAIL ZABI ULLAH,Independent,5818,0,5818,13
Karnataka,Bidar,KALLALING HUGAR NELOGI,Independent,2307,0,2307,14
Karnataka,Bidar,NAGANATH PATIL,Independent,2204,0,2204,15
Karnataka,Bidar,PRABHU,Independent,5097,0,5097,16
Karnataka,Bidar,BALBHEEM VEERAPPA UNNE,Independent,7118,0,7118,17
Karnataka,Bidar,BABU PASHA,Independent,2869,0,2869,18
Karnataka,Bidar,MACHENDAR,Independent,4379,0,4379,19
Karnataka,Bidar,MIRZA SHAFEE BAIG,Independent,1462,0,1462,20
Karnataka,Bidar,MOHAMMED RAFIQ,Independent,2095,0,2095,21
Karnataka,Bidar,SHAMALA.M.UDANOOR,Independent,1259,0,1259,22
Karnataka,Bidar,SIDDARAMAPPA NAGAPPA KARABASTI CHINCHANSOOR,Independent,1742,0,1742,23
Karnataka,Bidar,SUBHASH BHIMSHA SINDANKERA,Independent,1406,0,1406,24
Karnataka,Bidar,None of the Above,NOTA,2816,1,2817,25
Karnataka,Koppal,KARADI SANGANNA AMARAPPA,Bharatiya Janata Party,486188,195,486383,1
Karnataka,Koppal,BASAVARAJ HITNAL,Indian National Congress,453873,96,453969,2
Karnataka,Koppal,SYED  ARIF,Bahujan Samaj Party,9529,0,9529,3
Karnataka,Koppal,THIMMAPPA UPPAR,BDBRAJP,2459,0,2459,4
Karnataka,Koppal,NAZEER HUSSAIN,Rashtriya Krantikari Samajwadi Party,2129,0,2129,5
Karnataka,Koppal,COM I:- D H PUJAR,Communist Party of India (Marxist),2635,1,2636,6
Karnataka,Koppal,BHARADWHAJA,Communist Party of India (Marxist-Lenninist) (Liberation),2089,0,2089,7
Karnataka,Koppal,RAMESH KOTI,Republican Party of India (A),1867,0,1867,8
Karnataka,Koppal,K. M. RANGANATHREDDY,Samajwadi Party,2305,0,2305,9
Karnataka,Koppal,SHIVAKUMAR NAVALISIDDAPPA TONTAPUR,Aam Aadmi Party,3422,3,3425,10
Karnataka,Koppal,ANOJIRAO G,Independent,2011,1,2012,11
Karnataka,Koppal,V. GOVINDA,Independent,6300,0,6300,12
Karnataka,Koppal,GOVINDHAREDDY PACHARALLI,Independent,2839,0,2839,13
Karnataka,Koppal,NAGAPPA. G.  KARATAGI,Independent,2894,0,2894,14
Karnataka,Koppal,B.MANOHARA HANUMANTAPPA,Independent,4433,0,4433,15
Karnataka,Koppal,SURESH,Independent,8292,0,8292,16
Karnataka,Koppal,None of the Above,NOTA,12945,2,12947,17
Karnataka,Bellary,R. RAVINAYAKA,Janata Dal (Secular),12613,0,12613,1
Karnataka,Bellary,B. RAMUDU (ADDIGERI RAMANNA),Bahujan Samaj Party,4555,2,4557,2
Karnataka,Bellary,B. SREERAMULU,Bharatiya Janata Party,534213,193,534406,3
Karnataka,Bellary,N.Y. HANUMANTAPPA,Indian National Congress,449155,107,449262,4
Karnataka,Bellary,A. DEVDAS,SOCIALIST UNITY CENTRE OF INDIA (COMMUNIST),8484,2,8486,5
Karnataka,Bellary,DODDAMANI PRASAD,Communist Party of India (Marxist-Lenninist) (Liberation),2456,0,2456,6
Karnataka,Bellary,G. NATARAJA,KAP,1996,1,1997,7
Karnataka,Bellary,COMRADE S. BHEEMAPPA,Communist Party of India (Marxist),2042,0,2042,8
Karnataka,Bellary,MALAGI SHIVAKUMAR GIRIYAPPA,Aam Aadmi Party,6034,4,6038,9
Karnataka,Bellary,K. RAGHAVENDRA,Pyramid Party of India,3497,4,3501,10
Karnataka,Bellary,N.B. KRISHNAPPA NAYAKA,Independent,3885,3,3888,11
Karnataka,Bellary,N.R. MALLAYYA SWAMY,Independent,5205,1,5206,12
Karnataka,Bellary,None of the Above,NOTA,11313,7,11320,13
Karnataka,Haveri,UDASI SHIVAKUMAR CHANNABASAPPA,Bharatiya Janata Party,566454,336,566790,1
Karnataka,Haveri,RAVI  MENASINAKAI,Janata Dal (Secular),9804,10,9814,2
Karnataka,Haveri,SALEEM  AHMED,Indian National Congress,479076,143,479219,3
Karnataka,Haveri,HALAPPA  TIMMENAHALLI,Bahujan Samaj Party,6227,2,6229,4
Karnataka,Haveri,D PRASAD,Republican Party of India (A),1489,1,1490,5
Karnataka,Haveri,BASAVANTEPPA HONNAPPA HULLATTI,SJPA,973,1,974,6
Karnataka,Haveri,H M SIRQUAZI,Aam Aadmi Party,1595,7,1602,7
Karnataka,Haveri,SURESH M.MUNDARGI,RCMP,771,0,771,8
Karnataka,Haveri,KABBINAD VERABHADRAPPA VEERAPPA,Independent,1224,0,1224,9
Karnataka,Haveri,KUBER VASANNA,Independent,882,1,883,10
Karnataka,Haveri,GIRISHGOUDA C.BISTANAGOUDAR,Independent,946,0,946,11
Karnataka,Haveri,CHANDRASHEKHARAYYA GURULINGAYYA KULKARNI,Independent,1312,2,1314,12
Karnataka,Haveri,B.M.JAYADEV MATHAD,Independent,2295,1,2296,13
Karnataka,Haveri,BIDARAGADDI  V.B,Independent,3528,0,3528,14
Karnataka,Haveri,MEHABOOBKHAN  PATHAN,Independent,2329,0,2329,15
Karnataka,Haveri,RUDRESH RAMANNA HADAGALI,Independent,7320,0,7320,16
Karnataka,Haveri,SHIDDAPPA KALLAPPA POOJAR,Independent,15656,0,15656,17
Karnataka,Haveri,SHIVAKUMAR  TALAWAR,Independent,3778,2,3780,18
Karnataka,Haveri,HANUMANTAPPA  D. KABBAR,Independent,5997,0,5997,19
Karnataka,Haveri,None of the Above,NOTA,3802,4,3806,20
Karnataka,Dharwad,IRAPPA BHARAMAPPA MADAR,Bahujan Samaj Party,6855,3,6858,1
Karnataka,Dharwad,PRALHAD JOSHI,Bharatiya Janata Party,544857,538,545395,2
Karnataka,Dharwad,BANKAPUR. HANUMANTHAPPA MALLAPPA,Janata Dal (Secular),8834,2,8836,3
Karnataka,Dharwad,VINAY KULKARNI,Indian National Congress,431509,229,431738,4
Karnataka,Dharwad,GURUSHANTAPPA H. CHALAVADI.,Republican Party of India (A),4126,2,4128,5
Karnataka,Dharwad,GANGADHAR S. BADIGER,SOCIALIST UNITY CENTRE OF INDIA (COMMUNIST),1785,0,1785,6
Karnataka,Dharwad,HEMANT KUMAR,Aam Aadmi Party,4344,5,4349,7
Karnataka,Dharwad,IMAMSAB MEHBOOBSAB TORGAL.,Independent,993,2,995,8
Karnataka,Dharwad,IRSHAD BEGAM ADHONI.,Independent,1053,0,1053,9
Karnataka,Dharwad,DOKKA ANANDARAJ,Independent,984,1,985,10
Karnataka,Dharwad,PRAMOD HANUMANTHARAO MUTHALIK,Independent,5459,6,5465,11
Karnataka,Dharwad,MARUTI RAMAPPA HANASI,Independent,1587,0,1587,12
Karnataka,Dharwad,VIKAS B. SOPPIN,Independent,2170,4,2174,13
Karnataka,Dharwad,SHAKEEL ABDULSATTAR DODWAD,Independent,1367,1,1368,14
Karnataka,Dharwad,SHREEKANT KABADI,Independent,3018,0,3018,15
Karnataka,Dharwad,SHAILENDRA PATIL,Independent,6196,0,6196,16
Karnataka,Dharwad,SANJAY KOTHARI,Independent,2359,0,2359,17
Karnataka,Dharwad,None of the Above,NOTA,12934,3,12937,18
Karnataka,Uttara Kannada,ANANTKUMAR HEGDE,Bharatiya Janata Party,546476,463,546939,1
Karnataka,Uttara Kannada,NAIK SANTHOSH,Bahujan Samaj Party,7403,1,7404,2
Karnataka,Uttara Kannada,PRASHANT R DESHPANDE,Indian National Congress,406116,123,406239,3
Karnataka,Uttara Kannada,ELIYAS KATI,SJPA,6281,0,6281,4
Karnataka,Uttara Kannada,OLWIN MARIAN LOPIS,Bahujan Mukti Party,1840,0,1840,5
Karnataka,Uttara Kannada,BASAVARAJ DUNDAPPA HADAPAD,RCMP,2029,3,2032,6
Karnataka,Uttara Kannada,RAGHAVENDRA K. THANE,Aam Aadmi Party,6211,4,6215,7
Karnataka,Uttara Kannada,ASHOK SAHADEVAPPA CHALAVADI,Independent,4246,0,4246,8
Karnataka,Uttara Kannada,SADANAND DESHBHANDARI ANNAPPA,Independent,3565,0,3565,9
Karnataka,Uttara Kannada,None of the Above,NOTA,16270,7,16277,10
Karnataka,Davanagere,A.K.PARASHURAMA KOTEMALLUR,Bahujan Samaj Party,5581,0,5581,1
Karnataka,Davanagere,S.S. MALLIKARJUN,Indian National Congress,501194,93,501287,2
Karnataka,Davanagere,MAHIMA J PATEL,Janata Dal (Secular),46901,10,46911,3
Karnataka,Davanagere,COM. H.K. RAMACHANDRAPPA,Communist Party of India,8064,0,8064,4
Karnataka,Davanagere,G M SIDDESHWARA,Bharatiya Janata Party,518624,270,518894,5
Karnataka,Davanagere,H.K. KENCHVEERAPPA,Vichara Jagruthi Congress Paksha,3972,0,3972,6
Karnataka,Davanagere,G.C.PATEL,SJPA,1145,0,1145,7
Karnataka,Davanagere,PARASURAM KURUBAR,Communist Party of India (Marxist-Lenninist) (Liberation),1332,0,1332,8
Karnataka,Davanagere,K.J. BASAVARAJ,Aam Aadmi Party,2582,0,2582,9
Karnataka,Davanagere,ALUR M.G. SWAMY,Independent,1122,0,1122,10
Karnataka,Davanagere,A.T. DADAKHALANDAR,Independent,1331,0,1331,11
Karnataka,Davanagere,SRI NAGARAJAPPA,Independent,1226,0,1226,12
Karnataka,Davanagere,DR. SRIDHARA UDUPA,Independent,946,0,946,13
Karnataka,Davanagere,SIDDESH,Independent,1216,0,1216,14
Karnataka,Davanagere,G.M.SIDDESHI,Independent,2732,0,2732,15
Karnataka,Davanagere,S.S. SUBHAN KHAN,Independent,3312,0,3312,16
Karnataka,Davanagere,K SYED ZABIULLA,Independent,1582,0,1582,17
Karnataka,Davanagere,B. GNANA PRAKASH,Independent,7097,0,7097,18
Karnataka,Davanagere,None of the Above,NOTA,4535,1,4536,19
Karnataka,Shimoga,KUNAJE  MANJUNATHA  GOWDA,Bahujan Samaj Party,5053,0,5053,1
Karnataka,Shimoga,GEETHA  SHIVARAJKUMAR,Janata Dal (Secular),240533,103,240636,2
Karnataka,Shimoga,MANJUNATH BHANDARY,Indian National Congress,242846,65,242911,3
Karnataka,Shimoga,B. S. YEDDYURAPPA,Bharatiya Janata Party,605654,562,606216,4
Karnataka,Shimoga,B. DHARMAPPA,Janata Dal (United),4537,0,4537,5
Karnataka,Shimoga,FAYAZ AHAMED   ALIAS   MOHAMAD FAYAZ AHAMED,SJPA,1339,0,1339,6
Karnataka,Shimoga,B.K. SHASHI KUMAR,KAP,3869,0,3869,7
Karnataka,Shimoga,K.G. SREEDHAR,Aam Aadmi Party,7539,3,7542,8
Karnataka,Shimoga,ANIL.M.R,Independent,1517,0,1517,9
Karnataka,Shimoga,MAINUDDIN M.S.,Independent,1294,1,1295,10
Karnataka,Shimoga,SHRILATHA SHETTY,Independent,2070,3,2073,11
Karnataka,Shimoga,S. SATISH SALIAN,Independent,2234,0,2234,12
Karnataka,Shimoga,H.  SURESHA POOJARI,Independent,2709,0,2709,13
Karnataka,Shimoga,None of the Above,NOTA,7073,4,7077,14
Karnataka,Udupi Chikmagalur,K JAYAPRAKASH HEGDE,Indian National Congress,399216,309,399525,1
Karnataka,Udupi Chikmagalur,ZAKIR HUSSAIN,Bahujan Samaj Party,7445,4,7449,2
Karnataka,Udupi Chikmagalur,V. DHANANJAYA KUMAR,Janata Dal (Secular),14886,9,14895,3
Karnataka,Udupi Chikmagalur,S VIJAYA KUMAR,Communist Party of India,9689,2,9691,4
Karnataka,Udupi Chikmagalur,SHOBHA KARANDLAJE,Bharatiya Janata Party,580450,718,581168,5
Karnataka,Udupi Chikmagalur,GURUDEVA S  H,Aam Aadmi Party,6043,6,6049,6
Karnataka,Udupi Chikmagalur,COMRADE C J JAGANNATH,Communist Party of India (Marxist),1612,0,1612,7
Karnataka,Udupi Chikmagalur,M D MAINUDDIN KHAN ALIAS ASFIYA,Independent,1214,0,1214,8
Karnataka,Udupi Chikmagalur,MANJUNATHA G,Independent,1089,0,1089,9
Karnataka,Udupi Chikmagalur,SRINIVASA POOJARY,Independent,1897,2,1899,10
Karnataka,Udupi Chikmagalur,SUDHEER KANCHAN,Independent,1689,0,1689,11
Karnataka,Udupi Chikmagalur,None of the Above,NOTA,7821,7,7828,12
Karnataka,Hassan,A.P. AHAMAD,Bahujan Samaj Party,18902,3,18905,1
Karnataka,Hassan,H.D. DEVEGOWDA,Janata Dal (Secular),509601,240,509841,2
Karnataka,Hassan,MANJU. A.,Indian National Congress,409240,139,409379,3
Karnataka,Hassan,C.H. VIJAYASHANKAR,Bharatiya Janata Party,165416,272,165688,4
Karnataka,Hassan,MANJUNATHA,BDBRAJP,3534,2,3536,5
Karnataka,Hassan,RUDREGOWDA,JVBP,3262,0,3262,6
Karnataka,Hassan,H.D. REVANNA,KAP,6798,0,6798,7
Karnataka,Hassan,SANTHOSH MOHAN,Aam Aadmi Party,8014,4,8018,8
Karnataka,Hassan,T.D. JAGADEESHA,Independent,2083,0,2083,9
Karnataka,Hassan,JAVARAIAH,Independent,1581,0,1581,10
Karnataka,Hassan,DR. BANUPRAKASH. K,Independent,1456,0,1456,11
Karnataka,Hassan,S.N. MALLAPPA,Independent,2387,1,2388,12
Karnataka,Hassan,M.MAHESH (HARSHA),Independent,3062,0,3062,13
Karnataka,Hassan,S.B. RAJEGOWDA,Independent,3841,0,3841,14
Karnataka,Hassan,None of the Above,NOTA,7331,3,7334,15
Karnataka,Dakshina Kannada,JANARDHANA POOJARY,Indian National Congress,498972,58,499030,1
Karnataka,Dakshina Kannada,NALIN KUMAR KATEEL,Bharatiya Janata Party,642452,287,642739,2
Karnataka,Dakshina Kannada,MOOSE KUNHI ALIAS ABDUL KAREEM,Bahujan Samaj Party,4471,0,4471,3
Karnataka,Dakshina Kannada,K YADAVA SHETTY,Communist Party of India  (Marxist),9393,1,9394,4
Karnataka,Dakshina Kannada,M. R. VASUDEVA,Aam Aadmi Party,5440,2,5442,5
Karnataka,Dakshina Kannada,SUPREETH KUMAR POOJARY,Hindustan Janta Party,657,0,657,6
Karnataka,Dakshina Kannada,HANEEF KHAN KODAJE,Social Democratic Party of India,27253,1,27254,7
Karnataka,Dakshina Kannada,ADVOCATE ANANDA GATTY,Independent,1116,0,1116,8
Karnataka,Dakshina Kannada,K. KUSHALA BELLARE,Independent,800,1,801,9
Karnataka,Dakshina Kannada,DEEPAK RAJESH COELHO,Independent,904,1,905,10
Karnataka,Dakshina Kannada,MAXIM PINTO,Independent,1072,0,1072,11
Karnataka,Dakshina Kannada,SUDATTA JAIN SHIRTHADY,Independent,1613,0,1613,12
Karnataka,Dakshina Kannada,SUBRAMANYA GOWDA K.,Independent,2449,1,2450,13
Karnataka,Dakshina Kannada,K.N. SOMASHEKAR,Independent,3421,0,3421,14
Karnataka,Dakshina Kannada,None of the Above,NOTA,7107,2,7109,15
Karnataka,Chitradurga,B.N.CHANDRAPPA,Indian National Congress,467372,139,467511,1
Karnataka,Chitradurga,JANARDHANA SWAMY,Bharatiya Janata Party,365963,257,366220,2
Karnataka,Chitradurga,T.D.RAJAGIRI,Bahujan Samaj Party,9441,0,9441,3
Karnataka,Chitradurga,GULLIHATTY.D.SHEKHAR,Janata Dal (Secular),202044,64,202108,4
Karnataka,Chitradurga,M.KUMBAIAH,Janata Dal (United),3970,0,3970,5
Karnataka,Chitradurga,S. MEETYA NAIK,Samajwadi Party,3558,0,3558,6
Karnataka,Chitradurga,MOHANA DASARI,Aam Aadmi Party,14226,0,14226,7
Karnataka,Chitradurga,H.SIDDAGANGAPPA,ANC,2951,0,2951,8
Karnataka,Chitradurga,GANESHA,Independent,2815,1,2816,9
Karnataka,Chitradurga,T.DAYANANDA,Independent,1818,0,1818,10
Karnataka,Chitradurga,BASAVANAGIDEVA SHARANARU,Independent,2171,0,2171,11
Karnataka,Chitradurga,T.BHAVANA,Independent,3601,0,3601,12
Karnataka,Chitradurga,N.S.MANJUNATHA NERENAHAL,Independent,2702,0,2702,13
Karnataka,Chitradurga,T.SOMESH SHILPI,Independent,4511,0,4511,14
Karnataka,Chitradurga,None of the Above,NOTA,8894,1,8895,15
Karnataka,Tumkur,A.KRISHNAPPA,Janata Dal (Secular),258603,80,258683,1
Karnataka,Tumkur,CHINNAPPA.V,Communist Party of India,10448,0,10448,2
Karnataka,Tumkur,NILUFAR JAMANI AHMED,Bahujan Samaj Party,4731,1,4732,3
Karnataka,Tumkur,G.S.BASAVARAJ,Bharatiya Janata Party,355394,433,355827,4
Karnataka,Tumkur,MUDDAHANUMEGOWDA.S.P.,Indian National Congress,429635,233,429868,5
Karnataka,Tumkur,A.S.D''''SILVA,Aam Aadmi Party,8321,1,8322,6
Karnataka,Tumkur,H.L.MOHAN KUMAR,Hindustan Janta Party,1528,0,1528,7
Karnataka,Tumkur,B.VENKATESHA,KAP,2390,0,2390,8
Karnataka,Tumkur,ANWAR,Independent,1245,0,1245,9
Karnataka,Tumkur,GOVINDARJU.G,Independent,1063,0,1063,10
Karnataka,Tumkur,G.NAGENDRA,Independent,1094,0,1094,11
Karnataka,Tumkur,BRAHMANANDA REDDY,Independent,1673,0,1673,12
Karnataka,Tumkur,L.P.YADUNANDANA,Independent,1507,0,1507,13
Karnataka,Tumkur,SHIVAKUMAR,Independent,1674,0,1674,14
Karnataka,Tumkur,K.V.SRINIVAS KALKERE,Independent,2195,0,2195,15
Karnataka,Tumkur,S.B.HANUMANTHARAYAPPA,Independent,6301,0,6301,16
Karnataka,Tumkur,None of the Above,NOTA,12933,1,12934,17
Karnataka,Mandya,M.KRISHNAMURTHY,Bahujan Samaj Party,22366,25,22391,1
Karnataka,Mandya,C.S.PUTTARAJU,Janata Dal (Secular),523942,428,524370,2
Karnataka,Mandya,RAMYA,Indian National Congress,518568,284,518852,3
Karnataka,Mandya,PROF. B.SHIVALINGAIAH,Bharatiya Janata Party,86909,84,86993,4
Karnataka,Mandya,H.K.KRISHNA,KAP,8604,0,8604,5
Karnataka,Mandya,KRISHNAMURTHY KOMMERAHALLI,Republican Party of India (A),1643,0,1643,6
Karnataka,Mandya,JAYACHANDRA,Bahujan Mukti Party,1119,0,1119,7
Karnataka,Mandya,K.MAHADEVAPPA,BDBRAJP,1423,0,1423,8
Karnataka,Mandya,K.SHIVANANDA,Hindustan Janta Party,1165,0,1165,9
Karnataka,Mandya,DR. C.S.HANUMANTHAPPA,Aam Aadmi Party,4096,2,4098,10
Karnataka,Mandya,ARAVIND PREMANAND,Independent,1171,1,1172,11
Karnataka,Mandya,ARUNAKUMARA,Independent,1178,1,1179,12
Karnataka,Mandya,ASHRAF,Independent,2163,0,2163,13
Karnataka,Mandya,K.UDAYAKUMARA,Independent,3070,0,3070,14
Karnataka,Mandya,N.C.PUTTARAJU,Independent,4019,2,4021,15
Karnataka,Mandya,BHANUPRAKASH.K.L,Independent,4354,0,4354,16
Karnataka,Mandya,None of the Above,NOTA,6015,6,6021,17
Karnataka,Mysore,ADAGOORU H VISHWANATH,Indian National Congress,471635,665,472300,1
Karnataka,Mysore,CHANDRASHEKARAIAH,Janata Dal (Secular),138460,127,138587,2
Karnataka,Mysore,PRATHAP SIMHA,Bharatiya Janata Party,502543,1365,503908,3
Karnataka,Mysore,C MOHAN KUMAR,Bahujan Samaj Party,13613,24,13637,4
Karnataka,Mysore,THIMME GOWDA,SJPA,1507,9,1516,5
Karnataka,Mysore,D S NIRVANAPPA,Communist Party of India (Marxist),977,1,978,6
Karnataka,Mysore,PADMAMMA M V,Aam Aadmi Party,5638,12,5650,7
Karnataka,Mysore,S P MAHADEVAPPA,Janata Dal (United),1013,3,1016,8
Karnataka,Mysore,RATHI POOVAIAH,KAP,3714,12,3726,9
Karnataka,Mysore,HUNSUR K CHANDRASHEKAR,DPPS,1342,0,1342,10
Karnataka,Mysore,D ESWAR THOREMAVU,Independent,1235,11,1246,11
Karnataka,Mysore,BANNUR KUMAR,Independent,1213,2,1215,12
Karnataka,Mysore,PRAVEEN M S,Independent,1434,5,1439,13
Karnataka,Mysore,BOJANNA N SOMAIAH,Independent,2032,0,2032,14
Karnataka,Mysore,SAMPATHU N,Independent,2076,2,2078,15
Karnataka,Mysore,None of the Above,NOTA,8914,10,8924,16
Karnataka,Chamarajanagar,A. R. KRISHNA MURTHY,Bharatiya Janata Party,426310,290,426600,1
Karnataka,Chamarajanagar,R. DHRUVANARAYANA,Indian National Congress,567587,195,567782,2
Karnataka,Chamarajanagar,M SHIVANNA (KOTE),Janata Dal (Secular),58734,26,58760,3
Karnataka,Chamarajanagar,SHIVAMALLU,Bahujan Samaj Party,34831,15,34846,4
Karnataka,Chamarajanagar,KATHAVARAY,asdp,1947,2,1949,5
Karnataka,Chamarajanagar,B GURUSWAMY,Samajwadi Party,2043,0,2043,6
Karnataka,Chamarajanagar,CHAUDAHALLY JAVARAIAH,Communist Party of India (Marxist-Lenninist) (Liberation),2008,0,2008,7
Karnataka,Chamarajanagar,PRADEEP KUMAR M,KAP,2491,1,2492,8
Karnataka,Chamarajanagar,KANDEGALA SRINIVASAMURTHY,Communist Party of India (Marxist),1825,0,1825,9
Karnataka,Chamarajanagar,SAMPATH KUMAR,Aam Aadmi Party,3357,0,3357,10
Karnataka,Chamarajanagar,BANNUR SURENDRA,SJPA,2762,0,2762,11
Karnataka,Chamarajanagar,ANANDA G,Independent,3906,0,3906,12
Karnataka,Chamarajanagar,S. GOVINDA NAIK,Independent,5398,0,5398,13
Karnataka,Chamarajanagar,NIRMALA KUMARI,Independent,6604,0,6604,14
Karnataka,Chamarajanagar,None of the Above,NOTA,12694,3,12697,15
Karnataka,Bangalore Rural,C THOPAIAH,Bahujan Samaj Party,11593,1,11594,1
Karnataka,Bangalore Rural,R. PRABHAKARA REDDY,Janata Dal (Secular),317828,42,317870,2
Karnataka,Bangalore Rural,MUNIRAJU GOWDA . P,Bharatiya Janata Party,421150,93,421243,3
Karnataka,Bangalore Rural,D K SURESH,Indian National Congress,652626,97,652723,4
Karnataka,Bangalore Rural,BASAVEGOWDA,Republican Party of India (A),6154,0,6154,5
Karnataka,Bangalore Rural,K A MOHAN,Kamarajar Deseeya Congress,1345,0,1345,6
Karnataka,Bangalore Rural,RAVI KRISHNA REDDY,Aam Aadmi Party,17192,3,17195,7
Karnataka,Bangalore Rural,SHANKARAPPA,JVBP,1008,0,1008,8
Karnataka,Bangalore Rural,KENCHAIAH,Independent,859,0,859,9
Karnataka,Bangalore Rural,J NATARAJU,Independent,957,1,958,10
Karnataka,Bangalore Rural,J.T.PRAKASH,Independent,1502,1,1503,11
Karnataka,Bangalore Rural,MALLESHA,Independent,5420,0,5420,12
Karnataka,Bangalore Rural,M.P.MUNAWER SHARIFF,Independent,2577,0,2577,13
Karnataka,Bangalore Rural,S.SIDDARAMAIAH (HEGGADE),Independent,2142,0,2142,14
Karnataka,Bangalore Rural,SURESH,Independent,2782,0,2782,15
Karnataka,Bangalore Rural,None of the Above,NOTA,9868,3,9871,16
Karnataka,Bangalore North,ABDUL AZEEM,Janata Dal (Secular),92650,31,92681,1
Karnataka,Bangalore North,C.NARAYANA SWAMY,Indian National Congress,488356,206,488562,2
Karnataka,Bangalore North,V VELU,Bahujan Samaj Party,5584,2,5586,3
Karnataka,Bangalore North,D.V SADANANDA GOWDA,Bharatiya Janata Party,717355,971,718326,4
Karnataka,Bangalore North,SUN STAR D.JAYARAM,GaAP,3783,1,3784,5
Karnataka,Bangalore North,BABU  MATHEW,Aam Aadmi Party,28091,16,28107,6
Karnataka,Bangalore North,MUTHURAJU. M,Republican Party of India (A),829,0,829,7
Karnataka,Bangalore North,T.S.CHAITHANYA (S.J.R),Independent,911,0,911,8
Karnataka,Bangalore North,MANOHAR H.A.,Independent,919,0,919,9
Karnataka,Bangalore North,DR.MEERLAYAQ HUSSAIN,Independent,612,0,612,10
Karnataka,Bangalore North,MOHAMMED QUTBUDDIN,Independent,680,0,680,11
Karnataka,Bangalore North,S. RAMU,Independent,1131,0,1131,12
Karnataka,Bangalore North,MU.VENKATESH SIMHA BHOVI,Independent,1033,0,1033,13
Karnataka,Bangalore North,SUNIL.V.J,Independent,1561,0,1561,14
Karnataka,Bangalore North,None of the Above,NOTA,11990,6,11996,15
Karnataka,Bangalore central,NANDINI ALVA,Janata Dal (Secular),20357,30,20387,1
Karnataka,Bangalore central,P.C. MOHAN,Bharatiya Janata Party,556710,420,557130,2
Karnataka,Bangalore central,R. MOHAN RAJU,Bahujan Samaj Party,5802,4,5806,3
Karnataka,Bangalore central,RIZWAN ARSHAD,Indian National Congress,419476,154,419630,4
Karnataka,Bangalore central,ISMAIL KHAN SAIF ALI,All India Trinamool Congress,2275,1,2276,5
Karnataka,Bangalore central,ZAHEEDA  SHEREEN,SOCIALIST UNITY CENTRE OF INDIA (COMMUNIST),1198,0,1198,6
Karnataka,Bangalore central,V. BALAKRISHNAN,Aam Aadmi Party,39852,17,39869,7
Karnataka,Bangalore central,BUDAYYA .B. PUJERI,KAP,553,0,553,8
Karnataka,Bangalore central,H.L. MANJUNATHA,Kannada Chalavali Vatal Paksha,707,0,707,9
Karnataka,Bangalore central,KADUGUDI SONNAPPA,Republican Party of India (A),543,0,543,10
Karnataka,Bangalore central,AMBROSE D''''MELLO,Independent,366,0,366,11
Karnataka,Bangalore central,DHANANJAYA. H.H,Independent,422,0,422,12
Karnataka,Bangalore central,G. NARAYANASWAMY (KAPALI),Independent,1228,0,1228,13
Karnataka,Bangalore central,B.K. NARAYANA-SWAMY,Independent,700,0,700,14
Karnataka,Bangalore central,PRASHANTH.S.M,Independent,903,0,903,15
Karnataka,Bangalore central,DR. MEER LAYAQ HUSSAIN,Independent,1878,0,1878,16
Karnataka,Bangalore central,K.MURTHY,Independent,1507,0,1507,17
Karnataka,Bangalore central,MODI SAIFULLA,Independent,3204,0,3204,18
Karnataka,Bangalore central,BHOVI RAMA C.B.K,Independent,942,0,942,19
Karnataka,Bangalore central,RAMANUJ SINGH,Independent,1836,0,1836,20
Karnataka,Bangalore central,B.V.VENKATESHAPPA,Independent,668,0,668,21
Karnataka,Bangalore central,SHAFI AHMED,Independent,549,0,549,22
Karnataka,Bangalore central,E.SALAM,Independent,365,0,365,23
Karnataka,Bangalore central,SEETHA RAMAN.E,Independent,2543,0,2543,24
Karnataka,Bangalore central,SURAIYA ZAITHOON,Independent,519,0,519,25
Karnataka,Bangalore central,SYED ASIF BUKHAARI,Independent,411,0,411,26
Karnataka,Bangalore central,None of the Above,NOTA,8443,6,8449,27
Karnataka,Bangalore South,ANANTH KUMAR,Bharatiya Janata Party,633312,504,633816,1
Karnataka,Bangalore South,KHAN ABDUL R,Bahujan Samaj Party,2743,4,2747,2
Karnataka,Bangalore South,NANDAN NILEKANI,Indian National Congress,404980,261,405241,3
Karnataka,Bangalore South,RUTH MANORAMA,Janata Dal (Secular),25649,28,25677,4
Karnataka,Bangalore South,M. UMADEVI,SOCIALIST UNITY CENTRE OF INDIA (COMMUNIST),917,1,918,5
Karnataka,Bangalore South,GAYATHRI,Pyramid Party of India,484,0,484,6
Karnataka,Bangalore South,NINA P NAYAK,Aam Aadmi Party,21395,8,21403,7
Karnataka,Bangalore South,MAHADEVA SWAMY. B. M,BDBRAJP,427,1,428,8
Karnataka,Bangalore South,RAVIKUMARA T,Samajwadi Party,781,0,781,9
Karnataka,Bangalore South,G.R. SHIVASHANKAR,All India Forward Bloc,586,0,586,10
Karnataka,Bangalore South,SYED MEHABOOB,Janata Dal (United),365,0,365,11
Karnataka,Bangalore South,DR. KODUR VENKATESH,Independent,502,0,502,12
Karnataka,Bangalore South,GOVINDAIAH B.R.,Independent,672,0,672,13
Karnataka,Bangalore South,T.K. DASAR,Independent,929,0,929,14
Karnataka,Bangalore South,DR. PRADEEP GADUGESH,Independent,549,0,549,15
Karnataka,Bangalore South,PRABHU,Independent,2325,0,2325,16
Karnataka,Bangalore South,PRAMOD  MUTALIK,Independent,4246,1,4247,17
Karnataka,Bangalore South,T. E. MOSES,Independent,604,0,604,18
Karnataka,Bangalore South,YOGESH,Independent,2061,0,2061,19
Karnataka,Bangalore South,G. VENKATESH BHOVI,Independent,736,0,736,20
Karnataka,Bangalore South,SHAMBULINGEGOWDA (GANDIVADI),Independent,581,0,581,21
Karnataka,Bangalore South,SYED RAFIQ AHMED,Independent,245,1,246,22
Karnataka,Bangalore South,N. HANUMEGOWDA,Independent,414,0,414,23
Karnataka,Bangalore South,None of the Above,NOTA,7411,3,7414,24
Karnataka,Chikkballapur,H D KUMARA SWAMY,Janata Dal (Secular),345882,457,346339,1
Karnataka,Chikkballapur,CHITRA PRASAD,Bahujan Samaj Party,6277,2,6279,2
Karnataka,Chikkballapur,B N BACHE GOWDA,Bharatiya Janata Party,414254,1026,415280,3
Karnataka,Chikkballapur,M VEERAPPA MOILY,Indian National Congress,424491,309,424800,4
Karnataka,Chikkballapur,G V SREERAMA REDDY,Communist Party of India  (Marxist),26052,19,26071,5
Karnataka,Chikkballapur,K ARKESH,Aam Aadmi Party,6825,2,6827,6
Karnataka,Chikkballapur,YAKUB SHARIFF,Bahujan Mukti Party,929,2,931,7
Karnataka,Chikkballapur,ROBIN MATHEWS NAREKATTU,Samajwadi Party,1404,0,1404,8
Karnataka,Chikkballapur,H N RAMAKRISHNA REDDY,Pyramid Party of India,686,0,686,9
Karnataka,Chikkballapur,REDDY G K C,Janata Dal (United),799,0,799,10
Karnataka,Chikkballapur,G C VENKATARAMANAPPA,Republican Party of India (A),892,0,892,11
Karnataka,Chikkballapur,B N GOPALAGOWDA,Independent,1465,0,1465,12
Karnataka,Chikkballapur,JAYAPRAKASHA YADAV,Independent,1586,0,1586,13
Karnataka,Chikkballapur,D N NARASIMHAMURTHY,Independent,1897,0,1897,14
Karnataka,Chikkballapur,NANJAPPA,Independent,1215,0,1215,15
Karnataka,Chikkballapur,T V MANJUNATHA GOWDA,Independent,3895,0,3895,16
Karnataka,Chikkballapur,G N RAVI,Independent,7127,0,7127,17
Karnataka,Chikkballapur,VENKATESH D T,Independent,3410,0,3410,18
Karnataka,Chikkballapur,K S SWAMY,Independent,4689,0,4689,19
Karnataka,Chikkballapur,None of the Above,NOTA,7676,6,7682,20
Karnataka,Kolar,D.M.AMBAREESHA,Bahujan Samaj Party,4934,0,4934,1
Karnataka,Kolar,KOLAR KESAVA,Janata Dal (Secular),370428,648,371076,2
Karnataka,Kolar,EM.NARAYANASWAMY,Bharatiya Janata Party,267211,111,267322,3
Karnataka,Kolar,K.H.MUNIYAPPA,Indian National Congress,418349,577,418926,4
Karnataka,Kolar,KOTIGANAHALLI RAMAIAH,Aam Aadmi Party,17558,5,17563,5
Karnataka,Kolar,V.MUNISWAMY,Samajwadi Party,4802,1,4803,6
Karnataka,Kolar,R.RAVINDRA KUMAR,BDBRAJP,1144,0,1144,7
Karnataka,Kolar,H.V.ANJAPPA,Independent,920,0,920,8
Karnataka,Kolar,K.NARENDRABABU,Independent,1089,0,1089,9
Karnataka,Kolar,NARAYANASWAMY,Independent,1517,0,1517,10
Karnataka,Kolar,M.S.NARAYANASWAMY,Independent,1291,0,1291,11
Karnataka,Kolar,H.N.NARAYANASWAMY,Independent,1583,0,1583,12
Karnataka,Kolar,A.PRASAD,Independent,1275,0,1275,13
Karnataka,Kolar,K.H.MADHUSOODAN,Independent,1759,0,1759,14
Karnataka,Kolar,M.MUNIYAPPA,Independent,2663,0,2663,15
Karnataka,Kolar,DR.C.MOHAN,Independent,2907,0,2907,16
Karnataka,Kolar,VINAYAKA PRASAD.H.N,Independent,2074,0,2074,17
Karnataka,Kolar,B.V.VENKATAGIRIYAPPA,Independent,6713,0,6713,18
Karnataka,Kolar,N.VENKATESH,Independent,3601,0,3601,19
Karnataka,Kolar,G.N.VENKATESH,Independent,6236,0,6236,20
Karnataka,Kolar,BEEDA SRINIVAS N,Independent,1398,0,1398,21
Karnataka,Kolar,V.SRINIVASA,Independent,1424,0,1424,22
Karnataka,Kolar,None of the Above,NOTA,5097,0,5097,23
Kerala,Kasaragod,P KARUNAKARAN,Communist Party of India  (Marxist),384209,755,384964,1
Kerala,Kasaragod,ADV. BASHEER ALADY,Bahujan Samaj Party,3103,1,3104,2
Kerala,Kasaragod,ADV. T SIDDIQUE,Indian National Congress,377579,464,378043,3
Kerala,Kasaragod,K SURENDRAN,Bharatiya Janata Party,172655,171,172826,4
Kerala,Kasaragod,ABDUL SALAM N U,Social Democratic Party of India,9713,0,9713,5
Kerala,Kasaragod,ABBAS MOTHALAPPARA,All India Trinamool Congress,631,1,632,6
Kerala,Kasaragod,AMBALATHARA KUNHIKRISHNAN,Aam Aadmi Party,4976,20,4996,7
Kerala,Kasaragod,ABOOBACKER SIDDIQ,Independent,880,0,880,8
Kerala,Kasaragod,K K ASHOKAN,Independent,3056,1,3057,9
Kerala,Kasaragod,GOTHRA MOOPAN NELLIKADAN KANNAN,Independent,2655,0,2655,10
Kerala,Kasaragod,KARUNAKARAN KALIPPURAYIL,Independent,824,0,824,11
Kerala,Kasaragod,KARUNAKARAN PAINGAPPADAN,Independent,1002,0,1002,12
Kerala,Kasaragod,MANOHARAN K,Independent,4194,0,4194,13
Kerala,Kasaragod,P K RAMAN,Independent,1221,1,1222,14
Kerala,Kasaragod,None of the Above,NOTA,6093,10,6103,15
Kerala,Kannur,N ABDULLA DAVUD,Bahujan Samaj Party,2108,1,2109,1
Kerala,Kannur,P C MOHANAN MASTER,Bharatiya Janata Party,51512,124,51636,2
Kerala,Kannur,P K SREEMATHI TEACHER,Communist Party of India  (Marxist),426478,1144,427622,3
Kerala,Kannur,K SUDHAKARAN,Indian National Congress,419996,1060,421056,4
Kerala,Kannur,P P ABOOBACKAR,Communist Party of India (Marxist),1535,1,1536,5
Kerala,Kannur,K K ABDUL JABBAR,Social Democratic Party of India,19169,1,19170,6
Kerala,Kannur,SASIDHARAN K V,Aam Aadmi Party,6080,26,6106,7
Kerala,Kannur,P P MOHANAN,Independent,2369,2,2371,8
Kerala,Kannur,SREEMATHI PUTHALATH,Independent,1500,0,1500,9
Kerala,Kannur,K SUDHAKARAN (KOLLON HOUSE),Independent,4239,1,4240,10
Kerala,Kannur,K SUDHAKARAN (SREESHYLAM),Independent,2744,1,2745,11
Kerala,Kannur,None of the Above,NOTA,7009,17,7026,12
Kerala,Vadakara,MULLAPPALLY RAMACHANDRAN,Indian National Congress,415445,1034,416479,1
Kerala,Vadakara,SASEENDRAN,Bahujan Samaj Party,2149,1,2150,2
Kerala,Vadakara,ADV.A.N.SHAMSEER,Communist Party of India  (Marxist),412055,1118,413173,3
Kerala,Vadakara,V.K.SAJEEVAN,Bharatiya Janata Party,76227,86,76313,4
Kerala,Vadakara,P.ABDUL HAMEED  MASTER,Social Democratic Party of India,15054,4,15058,5
Kerala,Vadakara,ALI AKBAR,Aam Aadmi Party,6230,15,6245,6
Kerala,Vadakara,A.M.SMITHA,Communist Party of India (Marxist),692,1,693,7
Kerala,Vadakara,ATTUVEPPIL KUNHIKKANNAN,Independent,731,0,731,8
Kerala,Vadakara,ADV.P.KUMARANKUTTY,Independent,17206,23,17229,9
Kerala,Vadakara,P.SHARAFUDEEN,Independent,1678,1,1679,10
Kerala,Vadakara,A.P.SHAMSEER,Independent,3485,0,3485,11
Kerala,Vadakara,None of the Above,NOTA,6093,14,6107,12
Kerala,Wayanad,P R RASMILNATH,Bharatiya Janata Party,80699,53,80752,1
Kerala,Wayanad,VAPPAN,Bahujan Samaj Party,1316,1,1317,2
Kerala,Wayanad,M I SHANAVAS,Indian National Congress,376751,284,377035,3
Kerala,Wayanad,SATHYAN MOKERI,Communist Party of India,355764,401,356165,4
Kerala,Wayanad,JALEEL NEELAMBRA,Social Democratic Party of India,14326,1,14327,5
Kerala,Wayanad,ADV. P P A SAGEER,Aam Aadmi Party,10675,9,10684,6
Kerala,Wayanad,SATHEESH CHANDRAN,All India Trinamool Congress,741,0,741,7
Kerala,Wayanad,SAM P MATHEW,Communist Party of India (Marxist),1222,0,1222,8
Kerala,Wayanad,RAMLA MAMPAD,Welfare Party of India,12626,19,12645,9
Kerala,Wayanad,P V ANVAR,Independent,37118,5,37123,10
Kerala,Wayanad,ABRAHAM BENHUR,Independent,1308,0,1308,11
Kerala,Wayanad,CLEATUS,Independent,1517,0,1517,12
Kerala,Wayanad,SATHYAN THAZHEMANGAD,Independent,5476,0,5476,13
Kerala,Wayanad,SATHYAN PUTHANVEETTIL,Independent,2855,0,2855,14
Kerala,Wayanad,SINOJ A C,Independent,1103,1,1104,15
Kerala,Wayanad,None of the Above,NOTA,10729,6,10735,16
Kerala,Kozhikode,C K.PADMANABHAN,Bharatiya Janata Party,115595,165,115760,1
Kerala,Kozhikode,M .K RAGHAVAN,Indian National Congress,396219,1396,397615,2
Kerala,Kozhikode,A.VIJAYARAGHAVAN,Communist Party of India  (Marxist),379655,1077,380732,3
Kerala,Kozhikode,VELAYUDHAN K.P.,Bahujan Samaj Party,1909,0,1909,4
Kerala,Kozhikode,MUSTHAFA KOMMERI,Social Democratic Party of India,10592,4,10596,5
Kerala,Kozhikode,K P RATHEESH,Aam Aadmi Party,13909,25,13934,6
Kerala,Kozhikode,THRISSUR NAZEER,Independent,665,0,665,7
Kerala,Kozhikode,ADV.N.P.PRATHAP KUMAR,Independent,6980,13,6993,8
Kerala,Kozhikode,MUHAMMED RIYAS,Independent,473,0,473,9
Kerala,Kozhikode,M RAGHAVAN,Independent,2331,0,2331,10
Kerala,Kozhikode,V M RAGHAVAN,Independent,964,0,964,11
Kerala,Kozhikode,M.VIJAYARAGHAVAN,Independent,2665,0,2665,12
Kerala,Kozhikode,VIJAYARAGHAVAN.K.,Independent,1991,0,1991,13
Kerala,Kozhikode,None of the Above,NOTA,6379,2,6381,14
Kerala,Malappuram,E. AHAMED,Indian Union Muslim League,437520,203,437723,1
Kerala,Malappuram,ILYAS,Bahujan Samaj Party,2744,1,2745,2
Kerala,Malappuram,ADV. N.SREEPRAKASH,Bharatiya Janata Party,64643,62,64705,3
Kerala,Malappuram,P.K.SAINABA,Communist Party of India  (Marxist),242775,209,242984,4
Kerala,Malappuram,PROF. P.ISMAIL,Welfare Party of India,29179,37,29216,5
Kerala,Malappuram,NASARUDHEEN ELAMARAM,Social Democratic Party of India,47843,10,47853,6
Kerala,Malappuram,ANWAR SHAKEEL OMAR,Independent,1214,1,1215,7
Kerala,Malappuram,DR. M.V. IBRAHIM,Independent,1376,0,1376,8
Kerala,Malappuram,GOPINATHAN.N,Independent,2491,0,2491,9
Kerala,Malappuram,SREEDHARAN,Independent,1329,1,1330,10
Kerala,Malappuram,None of the Above,NOTA,21822,7,21829,11
Kerala,Ponnani,T.AYYAPPAN,Bahujan Samaj Party,2151,2,2153,1
Kerala,Ponnani,K.NARAYANAN MASTER,Bharatiya Janata Party,75186,26,75212,2
Kerala,Ponnani,E. T. MOHAMMED BASHEER,Indian Union Muslim League,378409,94,378503,3
Kerala,Ponnani,V.T.IKRAMUL HAQUE,Social Democratic Party of India,26638,2,26640,4
Kerala,Ponnani,SHYLOCK P.V.,Aam Aadmi Party,9501,3,9504,5
Kerala,Ponnani,ABULLAIS.T.P,Independent,11026,8,11034,6
Kerala,Ponnani,ABDURAHMAN VADAKKATHINAKATH,Independent,2043,1,2044,7
Kerala,Ponnani,ABDURAHIMAN VAYARAKATH,Independent,1220,0,1220,8
Kerala,Ponnani,ABDURAHIMAN VARIKKOTTIL,Independent,2434,0,2434,9
Kerala,Ponnani,V.ABDURAHMAN,Independent,352957,136,353093,10
Kerala,Ponnani,BINDU M.K.,Independent,2261,0,2261,11
Kerala,Ponnani,None of the Above,NOTA,7493,1,7494,12
Kerala,Palakkad,M B RAJESH,Communist Party of India  (Marxist),412427,470,412897,1
Kerala,Palakkad,SOBHASURENDRAN,Bharatiya Janata Party,136492,95,136587,2
Kerala,Palakkad,HARI ARUMBIL,Bahujan Samaj Party,1961,2,1963,3
Kerala,Palakkad,ABOOBAKKER SIDHIKH,All India Trinamool Congress,828,0,828,4
Kerala,Palakkad,E S KHAJA HUSSAIN,Social Democratic Party of India,12503,1,12504,5
Kerala,Palakkad,B PADMANABHAN,Aam Aadmi Party,4924,9,4933,6
Kerala,Palakkad,RAJESH S,Shivsena,2654,0,2654,7
Kerala,Palakkad,THENNILAPURAM RADHAKRISHNAN,Welfare Party of India,8654,13,8667,8
Kerala,Palakkad,M P VEERENDRAKUMAR,SJD,307287,310,307597,9
Kerala,Palakkad,ABHIMOD,Independent,1231,0,1231,10
Kerala,Palakkad,PRADEEP,Independent,770,0,770,11
Kerala,Palakkad,C.K. RAMAKRISHNAN,Independent,1092,0,1092,12
Kerala,Palakkad,VEERENDRAKUMAR O P,Independent,3942,4,3946,13
Kerala,Palakkad,SREEJITH,Independent,1416,0,1416,14
Kerala,Palakkad,V S  SHANAVAS,Independent,1946,0,1946,15
Kerala,Palakkad,None of the Above,NOTA,11289,2,11291,16
Kerala,Alathur ,PREMAKUMARI,Bahujan Samaj Party,4436,0,4436,1
Kerala,Alathur ,P.K.BIJU,Communist Party of India  (Marxist),411310,498,411808,2
Kerala,Alathur ,SHAJU MON VATTEKKAD,Bharatiya Janata Party,87752,51,87803,3
Kerala,Alathur ,SHEEBA,Indian National Congress,373992,504,374496,4
Kerala,Alathur ,KRISHNAN ERANHIKKAL,Social Democratic Party of India,7820,0,7820,5
Kerala,Alathur ,ALBIN M U,Independent,5255,5,5260,6
Kerala,Alathur ,KRISHNANKUTTY V,Independent,932,0,932,7
Kerala,Alathur ,R BIJU,Independent,2159,0,2159,8
Kerala,Alathur ,A BIJU,Independent,1692,0,1692,9
Kerala,Alathur ,K BIJU,Independent,2911,0,2911,10
Kerala,Alathur ,VIJAYAN AMBALAKKAD,Independent,2101,1,2102,11
Kerala,Alathur ,K S VELAYUDHAN,Independent,4392,0,4392,12
Kerala,Alathur ,None of the Above,NOTA,21398,19,21417,13
Kerala,Thrissur,C. N. JAYADEVAN,Communist Party of India,388774,435,389209,1
Kerala,Thrissur,ADV. A. JAYARAM,Bahujan Samaj Party,2109,1,2110,2
Kerala,Thrissur,K. P. DHANAPALAN,Indian National Congress,350593,389,350982,3
Kerala,Thrissur,K.P. SREESAN,Bharatiya Janata Party,102625,56,102681,4
Kerala,Thrissur,HAJI MOIDEEN SHAH,Janata Dal (United),659,0,659,5
Kerala,Thrissur,K.SIVARAMAN,Communist Party of India (Marxist),718,0,718,6
Kerala,Thrissur,SARAH JOSEPH,Aam Aadmi Party,44583,55,44638,7
Kerala,Thrissur,SUFEERA K. P.,Social Democratic Party of India,6892,2,6894,8
Kerala,Thrissur,SOMAN PILLAI,igp,546,0,546,9
Kerala,Thrissur,JASMINSHA,Independent,3959,0,3959,10
Kerala,Thrissur,JIJU CHEENIKKAL,Independent,450,0,450,11
Kerala,Thrissur,M. NARAYANANKUTTY (M. N. KUTTY),Independent,616,0,616,12
Kerala,Thrissur,T. L. SANTHOSH,Independent,6043,1,6044,13
Kerala,Thrissur,MANIYANGATTIL SUKUMARAN,Independent,949,0,949,14
Kerala,Thrissur,None of the Above,NOTA,10041,9,10050,15
Kerala,Chalakudy,ADV. B. GOPALAKRISHNAN,Bharatiya Janata Party,92793,55,92848,1
Kerala,Chalakudy,P C CHACKO,Indian National Congress,344222,334,344556,2
Kerala,Chalakudy,M G PURUSHOTHAMAN,Bahujan Samaj Party,1942,0,1942,3
Kerala,Chalakudy,ANNAMMA JOY,All India Trinamool Congress,862,0,862,4
Kerala,Chalakudy,K. AMBUJAKSHAN,Welfare Party of India,12931,11,12942,5
Kerala,Chalakudy,JAYAN KONIKARA,Communist Party of India (Marxist),932,0,932,6
Kerala,Chalakudy,K M NOORDEEN,Aam Aadmi Party,35157,32,35189,7
Kerala,Chalakudy,SHAFEER MUHAMMED,Social Democratic Party of India,14384,2,14386,8
Kerala,Chalakudy,SAJI THURUTHIKUNNEL,Shivsena,1114,0,1114,9
Kerala,Chalakudy,ABDUL KAREEM,Independent,1376,0,1376,10
Kerala,Chalakudy,INNOCENT,Independent,358020,420,358440,11
Kerala,Chalakudy,JAISON PANIKULANGARA,Independent,2050,2,2052,12
Kerala,Chalakudy,EDAPPALLY BASHEER,Independent,1346,0,1346,13
Kerala,Chalakudy,T D BABURAJAN,Independent,900,0,900,14
Kerala,Chalakudy,VINCENT,Independent,4596,0,4596,15
Kerala,Chalakudy,None of the Above,NOTA,10546,6,10552,16
Kerala,Ernakulam,K C KARTHIKEYAN,Bahujan Samaj Party,2685,0,2685,1
Kerala,Ernakulam,PROF. K.V. THOMAS,Indian National Congress,353552,289,353841,2
Kerala,Ernakulam,A.N. RADHAKRISHNAN,Bharatiya Janata Party,98933,70,99003,3
Kerala,Ernakulam,ANITA PRATAP,Aam Aadmi Party,51454,63,51517,4
Kerala,Ernakulam,KRISHNANKUTTY M.K.,Communist Party of India (Marxist),950,0,950,5
Kerala,Ernakulam,P.D. CHANDRABHANU,Socialist Republican Party,6156,0,6156,6
Kerala,Ernakulam,DENSIL MENDEZ,Janata Dal (United),2629,1,2630,7
Kerala,Ernakulam,ZULFICAR ALI,Social Democratic Party of India,14822,3,14825,8
Kerala,Ernakulam,ANIL KUMAR,Independent,1180,0,1180,9
Kerala,Ernakulam,KISHORE,Independent,5011,0,5011,10
Kerala,Ernakulam,DR. CHRISTY FERNANDEZ,Independent,266372,422,266794,11
Kerala,Ernakulam,JUNO JOHN BABY,Independent,1080,0,1080,12
Kerala,Ernakulam,N J PIOUS,Independent,2342,2,2344,13
Kerala,Ernakulam,K.V. BHASKARAN,Independent,22723,10,22733,14
Kerala,Ernakulam,RAJANEESH BABU,Independent,8246,0,8246,15
Kerala,Ernakulam,ADV. RADHAKRISHNAN P T,Independent,2104,0,2104,16
Kerala,Ernakulam,None of the Above,NOTA,9726,9,9735,17
Kerala,Idukki,ADV.DEAN KURIAKOSE,Indian National Congress,330755,722,331477,1
Kerala,Idukki,APPANCHIRA PONNAPPAN,Bahujan Samaj Party,2476,1,2477,2
Kerala,Idukki,ADV.SABU VARGHESE,Bharatiya Janata Party,50405,33,50438,3
Kerala,Idukki,T.K.TOMY,Communist Party of India (Marxist),3970,1,3971,4
Kerala,Idukki,MUHAMMED SHARAFUDHEEN,Social Democratic Party of India,10401,0,10401,5
Kerala,Idukki,SILVI SUNIL,Aam Aadmi Party,11199,16,11215,6
Kerala,Idukki,ANISH MARIYIL,Independent,629,0,629,7
Kerala,Idukki,JAMES JOSEPH,Independent,1156,2,1158,8
Kerala,Idukki,JOYCE GEORGE,Independent,6024,0,6024,9
Kerala,Idukki,ADV.JOICE GEORGE,Independent,381638,381,382019,10
Kerala,Idukki,JOICE GEORGE,Independent,3057,0,3057,11
Kerala,Idukki,P.C.JOLLY,Independent,550,0,550,12
Kerala,Idukki,BIJU JOSEPH,Independent,493,0,493,13
Kerala,Idukki,ADV.CHITTOOR RAJAMANNAR,Independent,415,0,415,14
Kerala,Idukki,SHOBY JOSEPH,Independent,1179,0,1179,15
Kerala,Idukki,SOMINI PRABHAKARAN,Independent,1925,0,1925,16
Kerala,Idukki,None of the Above,NOTA,12325,13,12338,17
Kerala,Kottayam,JOSE K. MANI,Kerala Congress (M),423463,731,424194,1
Kerala,Kottayam,ADV.MATHEW T. THOMAS,Janata Dal (Secular),302981,614,303595,2
Kerala,Kottayam,SREENI K. JACOB,Bahujan Samaj Party,6730,2,6732,3
Kerala,Kottayam,ADV.ANIL AIKKARA,Aam Aadmi Party,26342,39,26381,4
Kerala,Kottayam,N.K.BIJU,SOCIALIST UNITY CENTRE OF INDIA (COMMUNIST),2872,7,2879,5
Kerala,Kottayam,SASIKKUTTAN VAKATHANAM,Communist Party of India (Marxist),1048,0,1048,6
Kerala,Kottayam,ROY ARACKAL,Social Democratic Party of India,3512,1,3513,7
Kerala,Kottayam,JAMES JOSEPH,Independent,1831,0,1831,8
Kerala,Kottayam,ADV.NOBLE MATHEW,Independent,44313,44,44357,9
Kerala,Kottayam,PRAVEEN K. MOHAN,Independent,924,1,925,10
Kerala,Kottayam,RATHEESH PERUMAL,Independent,2157,0,2157,11
Kerala,Kottayam,None of the Above,NOTA,14011,13,14024,12
Kerala,Alappuzha,C B CHANDRABABU,Communist Party of India  (Marxist),441571,1547,443118,1
Kerala,Alappuzha,P V NATESAN,Bahujan Samaj Party,3384,1,3385,2
Kerala,Alappuzha,K C VENUGOPAL,Indian National Congress,461101,1424,462525,3
Kerala,Alappuzha,PROF.A.V.THAMARAKSHAN,RSPK(B),43006,45,43051,4
Kerala,Alappuzha,THULASEEDHARAN PALLICKAL,Social Democratic Party of India,10989,4,10993,5
Kerala,Alappuzha,ADV.M.A.BINDU,SOCIALIST UNITY CENTRE OF INDIA (COMMUNIST),5918,3,5921,6
Kerala,Alappuzha,D MOHANAN,Aam Aadmi Party,9373,41,9414,7
Kerala,Alappuzha,CHANDRABABU G,Independent,1613,2,1615,8
Kerala,Alappuzha,JAYACHANDRAN SARASAMMA,Independent,481,0,481,9
Kerala,Alappuzha,M M PAULOSE,Independent,402,0,402,10
Kerala,Alappuzha,S.B.BASHEER,Independent,709,0,709,11
Kerala,Alappuzha,T S BALAKRISHNAN,Independent,1363,0,1363,12
Kerala,Alappuzha,VENUGOPAL P C,Independent,3148,1,3149,13
Kerala,Alappuzha,None of the Above,NOTA,11321,17,11338,14
Kerala,Mavelikkara ,ADV.P.K.JAYAKRISHNAN,Bahujan Samaj Party,3599,4,3603,1
Kerala,Mavelikkara ,ADV.P.SUDHEER,Bharatiya Janata Party,79666,77,79743,2
Kerala,Mavelikkara ,CHENGARA SURENDRAN,Communist Party of India,368892,803,369695,3
Kerala,Mavelikkara ,KODIKUNNIL SURESH,Indian National Congress,401485,947,402432,4
Kerala,Mavelikkara ,JYOTHISH PERUMPULICKAL,Social Democratic Party of India,8945,1,8946,5
Kerala,Mavelikkara ,SASIKALA K S,SOCIALIST UNITY CENTRE OF INDIA (COMMUNIST),4733,3,4736,6
Kerala,Mavelikkara ,N SADANANDAN,Aam Aadmi Party,7720,33,7753,7
Kerala,Mavelikkara ,PIRAVATHOOR SREEDHARAN,Independent,1206,1,1207,8
Kerala,Mavelikkara ,PALLICKAL SURENDRAN,Independent,1486,0,1486,9
Kerala,Mavelikkara ,None of the Above,NOTA,9448,11,9459,10
Kerala,Pathanamthitta,ANTO ANTONY,Indian National Congress,358435,407,358842,1
Kerala,Pathanamthitta,M T REMESH,Bharatiya Janata Party,138785,169,138954,2
Kerala,Pathanamthitta,SELEENA PRAKKANAM,Bahujan Samaj Party,10384,0,10384,3
Kerala,Pathanamthitta,ALEYAMMA VARGHESE,All India Trinamool Congress,1236,0,1236,4
Kerala,Pathanamthitta,MANSOOR THENGANA,Social Democratic Party of India,11351,2,11353,5
Kerala,Pathanamthitta,S RADHAMANI,SOCIALIST UNITY CENTRE OF INDIA (COMMUNIST),2894,7,2901,6
Kerala,Pathanamthitta,SABUKUTTY JOY (SABU PUTHUCHIRA),SLAP,682,0,682,7
Kerala,Pathanamthitta,AJITH KUMAR K. K,Independent,748,0,748,8
Kerala,Pathanamthitta,PEELIPOSE,Independent,16492,1,16493,9
Kerala,Pathanamthitta,ADV. PEELIPOSE THOMAS,Independent,302173,478,302651,10
Kerala,Pathanamthitta,PUSHPANGATHAN,Independent,953,0,953,11
Kerala,Pathanamthitta,MATHEW PAREY,Independent,384,0,384,12
Kerala,Pathanamthitta,S RADHAKRISHNAN,Independent,1021,0,1021,13
Kerala,Pathanamthitta,LALITHA MALAYALAPPUZHA,Independent,460,0,460,14
Kerala,Pathanamthitta,SHILVIN KOTTACKAKATHU,Independent,1005,0,1005,15
Kerala,Pathanamthitta,SANTHOSH KUMAR,Independent,4845,2,4847,16
Kerala,Pathanamthitta,None of the Above,NOTA,16528,10,16538,17
Kerala,Kollam,ADV.S.PRAHLADAN,Bahujan Samaj Party,4264,2,4266,1
Kerala,Kollam,M.A. BABY,Communist Party of India  (Marxist),369343,1536,370879,2
Kerala,Kollam,P.M. VELAYUDHAN,Bharatiya Janata Party,58605,66,58671,3
Kerala,Kollam,N.K.PREMACHANDRAN,Revolutionary Socialist Party,407021,1507,408528,4
Kerala,Kollam,A.K.SALAHUDEEN,Social Democratic Party of India,12811,1,12812,5
Kerala,Kollam,C. INDULAL EX-SERVICE MAN,Independent,1709,0,1709,6
Kerala,Kollam,A. JOSEKUTTY,Independent,1702,0,1702,7
Kerala,Kollam,R. PREMACHANDRAN,Independent,2807,1,2808,8
Kerala,Kollam,V.S. PREMACHANDRAN,Independent,3332,1,3333,9
Kerala,Kollam,M. BABY,Independent,3364,0,3364,10
Kerala,Kollam,K. BHASKARAN,Independent,3102,6,3108,11
Kerala,Kollam,None of the Above,NOTA,7861,15,7876,12
Kerala,Attingal,ANIL KUMAR N S,Bahujan Samaj Party,8584,2,8586,1
Kerala,Attingal,GIRIJA KUMARI.S,Bharatiya Janata Party,90395,133,90528,2
Kerala,Attingal,ADV.BINDHU KRISHNA,Indian National Congress,321540,1560,323100,3
Kerala,Attingal,DR.A .SAMPATH,Communist Party of India  (Marxist),391346,1132,392478,4
Kerala,Attingal,VAKKOM G AJITH,Shivsena,5511,0,5511,5
Kerala,Attingal,ADV. CHIRAYINKEEZHU GOPINATHAN,Republican Party of India (A),736,0,736,6
Kerala,Attingal,PRIYA SUNIL,Welfare Party of India,4857,5,4862,7
Kerala,Attingal,M.K.MANOJ KUMAR,Social Democratic Party of India,11223,2,11225,8
Kerala,Attingal,ADV.M. R.SARIN,Janata Dal (United),576,0,576,9
Kerala,Attingal,DAS K VARKALA,Independent,2375,0,2375,10
Kerala,Attingal,VIVEKANANDAN,Independent,615,0,615,11
Kerala,Attingal,SAMBATH ANILKUMAR,Independent,2221,0,2221,12
Kerala,Attingal,SUNILKRISHNAN,Independent,3848,2,3850,13
Kerala,Attingal,IRINCHAYAM SURESH,Independent,1052,0,1052,14
Kerala,Attingal,SURESHKUMAR THONNAKKAL,Independent,647,0,647,15
Kerala,Attingal,HARIHARAN K S,Independent,4063,1,4064,16
Kerala,Attingal,None of the Above,NOTA,6918,6,6924,17
Kerala,Thiruvananthapuram,DOCTOR BENNET ABRAHAM,Communist Party of India,248202,739,248941,1
Kerala,Thiruvananthapuram,O RAJAGOPAL,Bharatiya Janata Party,281818,518,282336,2
Kerala,Thiruvananthapuram,DR. SHASHI THAROOR,Indian National Congress,296319,1487,297806,3
Kerala,Thiruvananthapuram,J SUDHAKARAN,Bahujan Samaj Party,3256,4,3260,4
Kerala,Thiruvananthapuram,AJIT JOY,Aam Aadmi Party,14113,40,14153,5
Kerala,Thiruvananthapuram,R CHANDRIKA KATTAKADA,Republican Party of India,292,0,292,6
Kerala,Thiruvananthapuram,THOMAS JOSEPH,Republican Party of India (A),261,0,261,7
Kerala,Thiruvananthapuram,O V SREEDATH,Socialist Republican Party,356,0,356,8
Kerala,Thiruvananthapuram,KUNNIL SHAJAHAN,Social Democratic Party of India,4820,0,4820,9
Kerala,Thiruvananthapuram,M.SHAJAR KHAN,SOCIALIST UNITY CENTRE OF INDIA (COMMUNIST),1689,0,1689,10
Kerala,Thiruvananthapuram,ADV. PERURKADA HARIKUMAR,Shivsena,902,0,902,11
Kerala,Thiruvananthapuram,ANIL KUMAR Y,Independent,371,0,371,12
Kerala,Thiruvananthapuram,V S JAYAKUMAR,Independent,447,0,447,13
Kerala,Thiruvananthapuram,JAIN WILSON,Independent,2103,0,2103,14
Kerala,Thiruvananthapuram,GEORGE MANKIDIYIL,Independent,843,0,843,15
Kerala,Thiruvananthapuram,O M JYOTHEENDRA NATH,Independent,2448,0,2448,16
Kerala,Thiruvananthapuram,BENET BABU BENJAMIN,Independent,4229,0,4229,17
Kerala,Thiruvananthapuram,KUNNUKUZHI S MANI,Independent,1716,0,1716,18
Kerala,Thiruvananthapuram,SYAMALAKUMARI,Independent,1851,0,1851,19
Kerala,Thiruvananthapuram,FATHER STEPHEN,Independent,1271,0,1271,20
Kerala,Thiruvananthapuram,None of the Above,NOTA,3340,6,3346,21
Madhya Pradesh,MORENA,ANOOP MISHRA,Bharatiya Janata Party,375526,41,375567,1
Madhya Pradesh,MORENA,DR GOVIND SINGH,Indian National Congress,184252,1,184253,2
Madhya Pradesh,MORENA,BRINDAWAN SINGH SIKARWAR,Bahujan Samaj Party,242586,0,242586,3
Madhya Pradesh,MORENA,ARJUN SINGH (PAPPU KUSHWAH),Rashtriya Samanta Dal,3006,0,3006,4
Madhya Pradesh,MORENA,JAYANT SINGH TOMAR,Loktantrik Samajwadi Party,1429,0,1429,5
Madhya Pradesh,MORENA,DEVENDRA KUMAR AGRVAL,Aam Aadmi Party,13806,0,13806,6
Madhya Pradesh,MORENA,MANESH KUMAR RAWAT,Jai Maha Bharath Party,975,0,975,7
Madhya Pradesh,MORENA,RAJESH KUSHWAH,Samajwadi Party,5554,0,5554,8
Madhya Pradesh,MORENA,VISNU SHARMA VIRTHARE,All India Trinamool Congress,2114,0,2114,9
Madhya Pradesh,MORENA,SHAKTI SINGH TOMAR,RAHM,1145,0,1145,10
Madhya Pradesh,MORENA,ANOOP NAGAR,Independent,852,0,852,11
Madhya Pradesh,MORENA,AKASH GUPTA,Independent,809,0,809,12
Madhya Pradesh,MORENA,KULDEEP SINGH,Independent,1058,0,1058,13
Madhya Pradesh,MORENA,CHHAVENDRA,Independent,1969,0,1969,14
Madhya Pradesh,MORENA,RAM NARESH,Independent,3546,0,3546,15
Madhya Pradesh,MORENA,SATANDRA SINGH (TONY TOMAR),Independent,4347,0,4347,16
Madhya Pradesh,MORENA,SIYARAM SINGH CHOUDRI,Independent,6471,0,6471,17
Madhya Pradesh,MORENA,None of the Above,NOTA,4792,0,4792,18
Madhya Pradesh,BHIND,IMARTI DEVI,Indian National Congress,244505,8,244513,1
Madhya Pradesh,BHIND,DR. BHAGIRATH PRASAD,Bharatiya Janata Party,404417,57,404474,2
Madhya Pradesh,BHIND,MANISH KATROLIYA,Bahujan Samaj Party,33802,1,33803,3
Madhya Pradesh,BHIND,ANITA HITENDRA CHAUDHARY,Samajwadi Party,5198,0,5198,4
Madhya Pradesh,BHIND,KRISHNA DEVI,Aam Aadmi Party,7730,0,7730,5
Madhya Pradesh,BHIND,B.S. THANESWARIYA,Bahujan Mukti Party,1793,0,1793,6
Madhya Pradesh,BHIND,PHOOLSINGH BARAIYA,BA S D,20402,1,20403,7
Madhya Pradesh,BHIND,VIJAYSINGH KORI,All India Forward Bloc,2699,0,2699,8
Madhya Pradesh,BHIND,HAKIM SINGH,Independent,2899,0,2899,9
Madhya Pradesh,BHIND,None of the Above,NOTA,5572,0,5572,10
Madhya Pradesh,GWALIOR,AKHILESH YADAV,Communist Party of India  (Marxist),10292,5,10297,1
Madhya Pradesh,GWALIOR,ASHOK SINGH,Indian National Congress,412879,218,413097,2
Madhya Pradesh,GWALIOR,ALOK SHARMA,Bahujan Samaj Party,68155,41,68196,3
Madhya Pradesh,GWALIOR,NARENDRA SINGH TOMAR,Bharatiya Janata Party,442398,398,442796,4
Madhya Pradesh,GWALIOR,C.L. KARODIYA (PRIJAPATI),JND,4719,0,4719,5
Madhya Pradesh,GWALIOR,K. P. KAMTE,Bharatiya Rashtriya Mazdoor Dal,1605,2,1607,6
Madhya Pradesh,GWALIOR,KISHAN LAL KUSHWAH,Rashtriya Samanta Dal,1412,0,1412,7
Madhya Pradesh,GWALIOR,GEETA RAJPUT,ALHP,1067,0,1067,8
Madhya Pradesh,GWALIOR,NEELAM AGRWAL,Aam Aadmi Party,11505,5,11510,9
Madhya Pradesh,GWALIOR,BALWANT SINGH KUSHWAH ADVOCATE,Samajwadi Party,5326,1,5327,10
Madhya Pradesh,GWALIOR,MADAN MOHAN URF MOHAN SINGH TOMAR,bjyp,1475,2,1477,11
Madhya Pradesh,GWALIOR,VIKAS SHARMA,BhNaP,1408,0,1408,12
Madhya Pradesh,GWALIOR,SHIV SINGH KUSHAWAH,MAHP,2100,1,2101,13
Madhya Pradesh,GWALIOR,COMRADE SUNIL GOPAL,SOCIALIST UNITY CENTRE OF INDIA (COMMUNIST),2054,0,2054,14
Madhya Pradesh,GWALIOR,HIRADAY NARAYAN SINGH TOMAR (GUDDU),Akhil Bharat Hindu Mahasabha,2244,0,2244,15
Madhya Pradesh,GWALIOR,ASIF KHAN,Independent,4969,0,4969,16
Madhya Pradesh,GWALIOR,DEEPAK KUMAR BANSAL RANGWALE (PRERAK),Independent,2122,0,2122,17
Madhya Pradesh,GWALIOR,NARAYAN SINGH KUSHWAH,Independent,3961,2,3963,18
Madhya Pradesh,GWALIOR,PRAJESH CHOUDHARY,Independent,1980,1,1981,19
Madhya Pradesh,GWALIOR,CAPTAN BABU LAL GOSWAMI,Independent,2659,0,2659,20
Madhya Pradesh,GWALIOR,RAM PATHWAR KORI (RAMSEBAK),Independent,1686,1,1687,21
Madhya Pradesh,GWALIOR,None of the Above,NOTA,4214,5,4219,22
Madhya Pradesh,GUNA,JAIBHANSINGH PAWAIYA,Bharatiya Janata Party,395167,1077,396244,1
Madhya Pradesh,GUNA,JYOTIRADITYA M SCINDIA,Indian National Congress,516300,736,517036,2
Madhya Pradesh,GUNA,LAKHAN SINGH BAGHEL,Bahujan Samaj Party,27368,44,27412,3
Madhya Pradesh,GUNA,SHAILENDRA SINGH KUSHWAH,Aam Aadmi Party,4062,11,4073,4
Madhya Pradesh,GUNA,ANWAR KHAN,Independent,1321,0,1321,5
Madhya Pradesh,GUNA,GIRRAJ YADAV,Independent,3294,0,3294,6
Madhya Pradesh,GUNA,CHANDRAPAL SINGH TOMAR,Independent,2195,2,2197,7
Madhya Pradesh,GUNA,NAND KISHORE TYAGI,Independent,2066,6,2072,8
Madhya Pradesh,GUNA,NARAYANRAO GUPCHUP,Independent,2079,0,2079,9
Madhya Pradesh,GUNA,MAHENDRA KUMAR,Independent,2844,1,2845,10
Madhya Pradesh,GUNA,LALLI RAM RAI,Independent,5574,1,5575,11
Madhya Pradesh,GUNA,None of the Above,NOTA,12474,7,12481,12
Madhya Pradesh,SAGAR,GOVIND SINGH RAJPUT,Indian National Congress,361811,32,361843,1
Madhya Pradesh,SAGAR,LAXMI NARAYAN YADAV,Bharatiya Janata Party,482462,118,482580,2
Madhya Pradesh,SAGAR,SAROJ KATIYAR KURMI,Bahujan Samaj Party,19916,1,19917,3
Madhya Pradesh,SAGAR,ATUL MISHRA,Aam Aadmi Party,6324,4,6328,4
Madhya Pradesh,SAGAR,KASHIRAM PATEL,Gondvana Gantantra Party,1128,0,1128,5
Madhya Pradesh,SAGAR,VINAY KUMAR,Bhartiya Shakti Chetna Party,1565,0,1565,6
Madhya Pradesh,SAGAR,BHARAT SEN ADVOCATE,Independent,1556,0,1556,7
Madhya Pradesh,SAGAR,MAHENDRA KUMAR CHOUDHARY,Independent,1632,0,1632,8
Madhya Pradesh,SAGAR,SHITIN KESHRWANI,Independent,2020,0,2020,9
Madhya Pradesh,SAGAR,M. HANIF QURASHI,Independent,3856,0,3856,10
Madhya Pradesh,SAGAR,None of the Above,NOTA,9502,2,9504,11
Madhya Pradesh,TIKAMGARH,AHIRWAR DR. KAMLESH VERMA,Indian National Congress,214198,50,214248,1
Madhya Pradesh,TIKAMGARH,AHIRWAR SEWAK RAM,Bahujan Samaj Party,23964,11,23975,2
Madhya Pradesh,TIKAMGARH,KHANGAR NEERAJ,Communist Party of India,15194,0,15194,3
Madhya Pradesh,TIKAMGARH,DR. VIRENDRA KUMAR,Bharatiya Janata Party,422636,343,422979,4
Madhya Pradesh,TIKAMGARH,DR. AMBESH KUMARI AHIRWAR,Samajwadi Party,47492,5,47497,5
Madhya Pradesh,TIKAMGARH,AHIRWAR RAMCHARAN,PHRC,3094,0,3094,6
Madhya Pradesh,TIKAMGARH,RAMESH CHAND VERMA,Aam Aadmi Party,4984,8,4992,7
Madhya Pradesh,TIKAMGARH,GANESH KUMHAR,Independent,2230,0,2230,8
Madhya Pradesh,TIKAMGARH,GIRDHARI LAL KORI,Independent,5219,0,5219,9
Madhya Pradesh,TIKAMGARH,CHATURBHUJ SNEHI,Independent,4035,0,4035,10
Madhya Pradesh,TIKAMGARH,BHAGWAN DAS BANSHKAR,Independent,4400,0,4400,11
Madhya Pradesh,TIKAMGARH,LAKHAN LAL CHADHAR,Independent,4548,0,4548,12
Madhya Pradesh,TIKAMGARH,SHEEL CHANDRA AHIRWAR,Independent,3855,0,3855,13
Madhya Pradesh,TIKAMGARH,None of the Above,NOTA,10055,0,10055,14
Madhya Pradesh,DAMOH,DEVENDRA CHAOURASIA,Bahujan Samaj Party,31508,11,31519,1
Madhya Pradesh,DAMOH,PRAHALAD SINGH PATEL,Bharatiya Janata Party,512770,309,513079,2
Madhya Pradesh,DAMOH,CHOUDHARY MAHENDRA PRATAP SINGH,Indian National Congress,299680,100,299780,3
Madhya Pradesh,DAMOH,DIVAN UPENDR PRATAP SINGH (RAJA SAB),Bhartiya Shakti Chetna Party,16346,4,16350,4
Madhya Pradesh,DAMOH,SANTOSH BHARTI,Aam Aadmi Party,11289,9,11298,5
Madhya Pradesh,DAMOH,ANANT LAL BASOR,Independent,2836,0,2836,6
Madhya Pradesh,DAMOH,IRFAN KHAN,Independent,2580,0,2580,7
Madhya Pradesh,DAMOH,DR.GULAB KHAN MASTER,Independent,3429,0,3429,8
Madhya Pradesh,DAMOH,PRAHLAD SINGH PATEL,Independent,9259,7,9266,9
Madhya Pradesh,DAMOH,PRAHLAD SINGH LODI,Independent,9343,0,9343,10
Madhya Pradesh,DAMOH,None of the Above,NOTA,12598,2,12600,11
Madhya Pradesh,KHAJURAHO,NAGENDRA SINGH,Bharatiya Janata Party,474814,152,474966,1
Madhya Pradesh,KHAJURAHO,RAJA PATERIA,Indian National Congress,227455,21,227476,2
Madhya Pradesh,KHAJURAHO,RAM LAKHAN SINGH,Bahujan Samaj Party,60352,16,60368,3
Madhya Pradesh,KHAJURAHO,AMIT BHATNAGAR,Aam Aadmi Party,8927,3,8930,4
Madhya Pradesh,KHAJURAHO,AVNISH TIWARI,Shivsena,2625,0,2625,5
Madhya Pradesh,KHAJURAHO,IMRAN,Peace Party,1484,0,1484,6
Madhya Pradesh,KHAJURAHO,KRISHAN SHARAN BHAIYA RAJA BUNDELA,BBPSP,1679,0,1679,7
Madhya Pradesh,KHAJURAHO,JAGDEESH KUMAR PATEL,Apna Dal,2549,0,2549,8
Madhya Pradesh,KHAJURAHO,SMT. DURGA SHARMA / ALIAS MADHU KAPIL,BC,1936,0,1936,9
Madhya Pradesh,KHAJURAHO,MAHESH CHANDRA,Rashtriya Samanta Dal,3012,0,3012,10
Madhya Pradesh,KHAJURAHO,SIDDHARTH SUKHLAL KUSHWAHA,Samajwadi Party,40068,1,40069,11
Madhya Pradesh,KHAJURAHO,SANJEEV KUMAR MISHRA,All India Forward Bloc,3187,0,3187,12
Madhya Pradesh,KHAJURAHO,ANWAR KHAN,Independent,3505,0,3505,13
Madhya Pradesh,KHAJURAHO,AYENDRA  KUMAR SHARMA,Independent,4084,0,4084,14
Madhya Pradesh,KHAJURAHO,JAYANT PRATAP SINGH / VIJAY SINGH,Independent,5906,0,5906,15
Madhya Pradesh,KHAJURAHO,RAM NATH LODHEE,Independent,13826,0,13826,16
Madhya Pradesh,KHAJURAHO,SHRIDHAR KHARE,Independent,10996,1,10997,17
Madhya Pradesh,KHAJURAHO,None of the Above,NOTA,7878,0,7878,18
Madhya Pradesh,SATNA,AJAY  SINGH RAHUL BHAIYYA,Indian National Congress,366567,33,366600,1
Madhya Pradesh,SATNA,GANESH SINGH,Bharatiya Janata Party,375169,119,375288,2
Madhya Pradesh,SATNA,DHARMENDRA SINGH TIWARI,Bahujan Samaj Party,124593,9,124602,3
Madhya Pradesh,SATNA,JAGDISH SINGH,Aam Aadmi Party,7923,2,7925,4
Madhya Pradesh,SATNA,DADHIBAL PRASAD PATEL,Apna Dal,1503,0,1503,5
Madhya Pradesh,SATNA,MAHGOO SINGH MUTHEL,DaVP,950,0,950,6
Madhya Pradesh,SATNA,RAJ KUMAR GOTAM,Bhartiya Shakti Chetna Party,1202,0,1202,7
Madhya Pradesh,SATNA,VINOD KUMAR RAVI,BSDS,924,0,924,8
Madhya Pradesh,SATNA,SHYAM LAL KUSHWAHA,Gondvana Gantantra Party,2155,0,2155,9
Madhya Pradesh,SATNA,AJAY PRATAP SINGH,Independent,2021,0,2021,10
Madhya Pradesh,SATNA,ASHOK KUMAR SAKET,Independent,1694,0,1694,11
Madhya Pradesh,SATNA,KESHAV PRASAD TRIPATHI AD. K.P.,Independent,2253,0,2253,12
Madhya Pradesh,SATNA,BIRENDRA BHAI PATEL,Independent,5305,0,5305,13
Madhya Pradesh,SATNA,SHRI RAM SHUKLA RAJJAN,Independent,7986,0,7986,14
Madhya Pradesh,SATNA,None of the Above,NOTA,13035,1,13036,15
Madhya Pradesh,REWA,JANARDAN MISHRA,Bharatiya Janata Party,383246,74,383320,1
Madhya Pradesh,REWA,DEORAJ SINGH PATEL,Bahujan Samaj Party,175550,17,175567,2
Madhya Pradesh,REWA,SUNDERLAL TIWARI,Indian National Congress,214572,22,214594,3
Madhya Pradesh,REWA,ABDUL WAFATI ANSARI URF YUVRAJ TAILORS,Samata Party,7527,0,7527,4
Madhya Pradesh,REWA,PURNANAND TIWARI,Aam Aadmi Party,5834,1,5835,5
Madhya Pradesh,REWA,PRAMOD TIWARI,Bhartiya Shakti Chetna Party,4794,0,4794,6
Madhya Pradesh,REWA,MANGLESHWAR BHAIYA,NADP,1456,0,1456,7
Madhya Pradesh,REWA,RAMKISHAN NIRAT (SAKET),Republican Party of India (A),2055,0,2055,8
Madhya Pradesh,REWA,R.D. VISHWAKARMA,Apna Dal,3164,0,3164,9
Madhya Pradesh,REWA,GIRISH KUMAR GAUTAM,Independent,3260,0,3260,10
Madhya Pradesh,REWA,JANARDAN MISHRA,Independent,3608,0,3608,11
Madhya Pradesh,REWA,PRABHUNATH PRASAD SAKET,Independent,4388,1,4389,12
Madhya Pradesh,REWA,BRAMHADATTA MISHRA URF CHHOTE,Independent,4718,0,4718,13
Madhya Pradesh,REWA,VISHWA NATH DWIVEDI,Independent,5057,0,5057,14
Madhya Pradesh,REWA,None of the Above,NOTA,10658,0,10658,15
Madhya Pradesh,SIDHI,INDRAJEET KUMAR,Indian National Congress,367279,353,367632,1
Madhya Pradesh,SIDHI,RAMA SHANKAR SHAHWAL,Bahujan Samaj Party,39379,8,39387,2
Madhya Pradesh,SIDHI,RITI PATHAK,Bharatiya Janata Party,475286,392,475678,3
Madhya Pradesh,SIDHI,SMT. ASHA SINGH,RsAD,10036,1,10037,4
Madhya Pradesh,SIDHI,URMILA,Communist Party of India (Marxist),4348,0,4348,5
Madhya Pradesh,SIDHI,PUSPENDRA SINGH,Gondvana Gantantra Party,23285,13,23298,6
Madhya Pradesh,SIDHI,PANKAJ SINGH PATEL,Aam Aadmi Party,9685,6,9691,7
Madhya Pradesh,SIDHI,LAL BAHADUR SINGH,Samata Samadhan Party,1979,0,1979,8
Madhya Pradesh,SIDHI,SANAT KUMAR TRIPATHI,Bhartiya Shakti Chetna Party,5828,2,5830,9
Madhya Pradesh,SIDHI,"SUNIL SONI ""KHADDI""",BA S D,6627,0,6627,10
Madhya Pradesh,SIDHI,MOHD. JAHANGEER ANSARI,Independent,3763,0,3763,11
Madhya Pradesh,SIDHI,BRAHMANAND PRATAP SINGH,Independent,5472,0,5472,12
Madhya Pradesh,SIDHI,BHAGAWATI CHARAN PANDEY(NEELU),Independent,10725,0,10725,13
Madhya Pradesh,SIDHI,RAMAKANT PANDEY MALAIHNA,Independent,7579,0,7579,14
Madhya Pradesh,SIDHI,None of the Above,NOTA,17348,2,17350,15
Madhya Pradesh,SHAHDOL,DALPAT SINGH PARASTE,Bharatiya Janata Party,524876,543,525419,1
Madhya Pradesh,SHAHDOL,PARMESHWAR SINGH,Communist Party of India,27618,1,27619,2
Madhya Pradesh,SHAHDOL,PHOOL SINGH PARASTE,Bahujan Samaj Party,19396,13,19409,3
Madhya Pradesh,SHAHDOL,RAJES NANDINI SINGH,Indian National Congress,283912,206,284118,4
Madhya Pradesh,SHAHDOL,JOGENDRA SINGH,Bahujan Mukti Party,7149,2,7151,5
Madhya Pradesh,SHAHDOL,YOGESH KUMAR SINGH AD.,Samajwadi Party,5579,1,5580,6
Madhya Pradesh,SHAHDOL,RAM GOPAL SINGH,Bhartiya Shakti Chetna Party,5318,2,5320,7
Madhya Pradesh,SHAHDOL,RAMRATAN SINGH PAWLEY,Gondvana Gantantra Party,20811,23,20834,8
Madhya Pradesh,SHAHDOL,RAM SINGH,CSM,3848,1,3849,9
Madhya Pradesh,SHAHDOL,ER. VIJAY KUMAR KOL,Aam Aadmi Party,20276,36,20312,10
Madhya Pradesh,SHAHDOL,SAHDEV SINGH PARASTE,NPEP,5089,0,5089,11
Madhya Pradesh,SHAHDOL,MAHAVEER PARSHAD MANJHI,Independent,7507,0,7507,12
Madhya Pradesh,SHAHDOL,RAJU BAIGA,Independent,6647,0,6647,13
Madhya Pradesh,SHAHDOL,LALA KOL,Independent,8288,0,8288,14
Madhya Pradesh,SHAHDOL,None of the Above,NOTA,21372,4,21376,15
Madhya Pradesh,JABALPUR,AFTAB ALAM,Bahujan Samaj Party,16008,0,16008,1
Madhya Pradesh,JABALPUR,RAKESH SINGH,Bharatiya Janata Party,564567,42,564609,2
Madhya Pradesh,JABALPUR,VIVEK KRISHNA TANKHA,Indian National Congress,355962,8,355970,3
Madhya Pradesh,JABALPUR,MOHD. ADIL,Indian Union Muslim League,9053,0,9053,4
Madhya Pradesh,JABALPUR,DIGVIJAY SINGH (SENIOR JOURNLIST),Bhartiya Shakti Chetna Party,1852,0,1852,5
Madhya Pradesh,JABALPUR,"ER. PRAVIN GAJBHIYE ""DADA""",Bahujan Mukti Party,1412,0,1412,6
Madhya Pradesh,JABALPUR,MANAK LAL GONTIYA,APoI,4261,0,4261,7
Madhya Pradesh,JABALPUR,LAL DASH,Gondvana Gantantra Party,2233,1,2234,8
Madhya Pradesh,JABALPUR,"CAPTAIN HANFEE, VEER CHAKRA",Aam Aadmi Party,15976,1,15977,9
Madhya Pradesh,JABALPUR,NAVEEN JAIN (YOGACHARYA),Independent,2990,0,2990,10
Madhya Pradesh,JABALPUR,MALKHAN PATEL,Independent,1562,0,1562,11
Madhya Pradesh,JABALPUR,DR. DHAI AKSHAR (RAKESH SONKAR),Independent,2007,0,2007,12
Madhya Pradesh,JABALPUR,VIKRANT,Independent,2797,0,2797,13
Madhya Pradesh,JABALPUR,VINAY KUMAR JAIN,Independent,6400,0,6400,14
Madhya Pradesh,JABALPUR,VIRENDRA KUMAR SHARMA,Independent,7164,0,7164,15
Madhya Pradesh,JABALPUR,None of the Above,NOTA,7888,0,7888,16
Madhya Pradesh,MANDLA,OMKAR SINGH MARKAM,Indian National Congress,474909,342,475251,1
Madhya Pradesh,MANDLA,FAGGAN SINGH KULASTE,Bharatiya Janata Party,584540,1180,585720,2
Madhya Pradesh,MANDLA,SHAMBHU SINGH MARAVI,Bahujan Samaj Party,21258,8,21266,3
Madhya Pradesh,MANDLA,INDER SINGH UIKEY,APoI,11929,1,11930,4
Madhya Pradesh,MANDLA,KHUMAN SINGH ARMO,Aam Aadmi Party,11512,36,11548,5
Madhya Pradesh,MANDLA,ANUJ GANGA SINGH PATTA,Gondvana Gantantra Party,56565,7,56572,6
Madhya Pradesh,MANDLA,PHOOL SINGH DHURWEY,CSM,4973,7,4980,7
Madhya Pradesh,MANDLA,BAISHAKHOO MARAVI,BHSSP,4954,2,4956,8
Madhya Pradesh,MANDLA,MAHATALAL BARKADE,NPEP,6721,3,6724,9
Madhya Pradesh,MANDLA,GHANSHYAM KUDAPE,Independent,11265,0,11265,10
Madhya Pradesh,MANDLA,None of the Above,NOTA,28288,18,28306,11
Madhya Pradesh,BALAGHAT,ASHOK KUMAR MASIH,Communist Party of India,20284,13,20297,1
Madhya Pradesh,BALAGHAT,BODHSINGH BHAGAT,Bharatiya Janata Party,479123,1471,480594,2
Madhya Pradesh,BALAGHAT,"""YOGESH NANAJI SAMRITE""",Bahujan Samaj Party,46325,20,46345,3
Madhya Pradesh,BALAGHAT,HINA LIKHIRAM KAWRE,Indian National Congress,384182,371,384553,4
Madhya Pradesh,BALAGHAT,ANUBHA MUNJARE,Samajwadi Party,99361,31,99392,5
Madhya Pradesh,BALAGHAT,DR. ASRA ANJUM FAROOQUI,Republican Party of India (A),3242,1,3243,6
Madhya Pradesh,BALAGHAT,ASIF KHAN,MNDP,2652,0,2652,7
Madhya Pradesh,BALAGHAT,GAUTAM RAMTEKE,Republican Party of India (Khobragade),3250,0,3250,8
Madhya Pradesh,BALAGHAT,U. K. CHOUDHARY (MUNNA BHAIYA),Aam Aadmi Party,9862,36,9898,9
Madhya Pradesh,BALAGHAT,NANDLAL UIKEY,CSM,3008,0,3008,10
Madhya Pradesh,BALAGHAT,LAXMINARAYAN DEHARIYA,Bahujan Mukti Party,4419,8,4427,11
Madhya Pradesh,BALAGHAT,VIVEK MISHRA (LALU BHAIYA),Jai Maha Bharath Party,4396,1,4397,12
Madhya Pradesh,BALAGHAT,SMT. HIRASAN UIKEY,Gondvana Gantantra Party,15769,32,15801,13
Madhya Pradesh,BALAGHAT,SHANKAR KANSRE LODHI (SAMAJ SEWAK),Independent,6374,0,6374,14
Madhya Pradesh,BALAGHAT,JABALPUR HIGH COURT ADVOCATE AND WRITER SUKHARAM ASTKAR LANJI,Independent,11767,0,11767,15
Madhya Pradesh,BALAGHAT,"""SANDEEP SONI""",Independent,10441,3,10444,16
Madhya Pradesh,BALAGHAT,None of the Above,NOTA,6901,21,6922,17
Madhya Pradesh,CHHINDWARA,KAMAL NATH,Indian National Congress,559667,88,559755,1
Madhya Pradesh,CHHINDWARA,CHOUDHARY CHANDRABHAN KUBER SINGH,Bharatiya Janata Party,443103,115,443218,2
Madhya Pradesh,CHHINDWARA,NITINKUMAR SAHU,Bahujan Samaj Party,12240,1,12241,3
Madhya Pradesh,CHHINDWARA,ARVIND DONGRE,Bahujan Mukti Party,2483,1,2484,4
Madhya Pradesh,CHHINDWARA,PARDESHI HARTAPSHAH TIRGAM,Gondvana Gantantra Party,25628,0,25628,5
Madhya Pradesh,CHHINDWARA,MAHESH MADHAVLAL DUBEY,Aam Aadmi Party,5695,1,5696,6
Madhya Pradesh,CHHINDWARA,RAMESH PATIL,APoI,2872,0,2872,7
Madhya Pradesh,CHHINDWARA,SUBHASH SHUKLA,Samajwadi Party,2034,1,2035,8
Madhya Pradesh,CHHINDWARA,ER. KRIPA SHANKAR YADAV,Independent,2140,0,2140,9
Madhya Pradesh,CHHINDWARA,JALASRAM NAGWANSHI,Independent,3117,0,3117,10
Madhya Pradesh,CHHINDWARA,DWARKA PRASAD PAHADE,Independent,3450,0,3450,11
Madhya Pradesh,CHHINDWARA,DHANIRAM YADUVANSHI,Independent,6601,0,6601,12
Madhya Pradesh,CHHINDWARA,SITARAM SAREYAM,Independent,12762,0,12762,13
Madhya Pradesh,CHHINDWARA,None of the Above,NOTA,25498,1,25499,14
Madhya Pradesh,HOSHANGABAD,UDAY PRATAP SINGH,Bharatiya Janata Party,668201,927,669128,1
Madhya Pradesh,HOSHANGABAD,"DEVENDRA PATEL ""GUDDU BHAIYA""",Indian National Congress,278961,207,279168,2
Madhya Pradesh,HOSHANGABAD,PRADEEP AHIRWAR,Bahujan Samaj Party,14141,13,14154,3
Madhya Pradesh,HOSHANGABAD,JAY PRAKASH PATEL,Gondvana Gantantra Party,5222,3,5225,4
Madhya Pradesh,HOSHANGABAD,MAYA VISHWAKARMA,Aam Aadmi Party,17788,49,17837,5
Madhya Pradesh,HOSHANGABAD,UDAY PRATAP  SINGH,Independent,6363,15,6378,6
Madhya Pradesh,HOSHANGABAD,Devendra Patel urf Gudda Bhaiyya,Independent,13409,3,13412,7
Madhya Pradesh,HOSHANGABAD,MUKESH BABU AHIRWAR,Independent,7132,0,7132,8
Madhya Pradesh,HOSHANGABAD,None of the Above,NOTA,18731,10,18741,9
Madhya Pradesh,VIDISHA,AMAR SINGH PATEL,Bahujan Samaj Party,9688,11,9699,1
Madhya Pradesh,VIDISHA,LAKSHMAN SINGH,Indian National Congress,303449,201,303650,2
Madhya Pradesh,VIDISHA,SUSHMA SWARAJ,Bharatiya Janata Party,713556,792,714348,3
Madhya Pradesh,VIDISHA,KAMLESH SALLAM,Gondvana Gantantra Party,10820,4,10824,4
Madhya Pradesh,VIDISHA,GANESH RAJAK,Samata Party,1761,0,1761,5
Madhya Pradesh,VIDISHA,NARMADA PRASHAD AHIRWAR,Bahujan Mukti Party,1267,3,1270,6
Madhya Pradesh,VIDISHA,BABULAL,Samata Samadhan Party,1088,0,1088,7
Madhya Pradesh,VIDISHA,ENGINEEAR BHAGWAT SINGH RAJPUT,Aam Aadmi Party,5197,7,5204,8
Madhya Pradesh,VIDISHA,MANOJ KUMAR YADAV,Samajwadi Party,3292,1,3293,9
Madhya Pradesh,VIDISHA,SHOIAB KHAN,PRSP,2198,2,2200,10
Madhya Pradesh,VIDISHA,CHANDRESH SINGH,Independent,5359,0,5359,11
Madhya Pradesh,VIDISHA,RAMDAYAL KORI,Independent,4159,0,4159,12
Madhya Pradesh,VIDISHA,None of the Above,NOTA,10613,5,10618,13
Madhya Pradesh,BHOPAL,ALOK SANJAR,Bharatiya Janata Party,714081,97,714178,1
Madhya Pradesh,BHOPAL,P C SHARMA (PRAKASH MANGILAL SHARMA ),Indian National Congress,343471,11,343482,2
Madhya Pradesh,BHOPAL,SHAILENDRA KUMAR SHAILI,Communist Party of India,7643,0,7643,3
Madhya Pradesh,BHOPAL,SUNIL BORSE,Bahujan Samaj Party,10152,0,10152,4
Madhya Pradesh,BHOPAL,MD. ATEEK,PRSP,625,0,625,5
Madhya Pradesh,BHOPAL,ASHOK PAWAR,Samata Samadhan Party,551,0,551,6
Madhya Pradesh,BHOPAL,GAUTAM SHINDE,Apna Dal,613,1,614,7
Madhya Pradesh,BHOPAL,J C BARAI,SOCIALIST UNITY CENTRE OF INDIA (COMMUNIST),628,0,628,8
Madhya Pradesh,BHOPAL,BALBHADRA MISHRA,bjyp,522,1,523,9
Madhya Pradesh,BHOPAL,BADSHAH KHAN,NADP,622,0,622,10
Madhya Pradesh,BHOPAL,MUKESH KUMAR BANSAL,SaVP,763,0,763,11
Madhya Pradesh,BHOPAL,RACHNA DHINGRA,Aam Aadmi Party,21295,3,21298,12
Madhya Pradesh,BHOPAL,RAJARAM MEHAR,Pratap Shiv Sena,796,0,796,13
Madhya Pradesh,BHOPAL,RAJESH KEER,Bahujan Mukti Party,1348,0,1348,14
Madhya Pradesh,BHOPAL,VIJAY KUMAR,Communist Party of India (Marxist),1494,0,1494,15
Madhya Pradesh,BHOPAL,SHEEBA MALIK,Samajwadi Party,5742,0,5742,16
Madhya Pradesh,BHOPAL,MASTER SAJID SIDDIQUI,Social Democratic Party of India,5557,0,5557,17
Madhya Pradesh,BHOPAL,ABDUL TAHIR (BABLU - ADVOCATE),Independent,1878,0,1878,18
Madhya Pradesh,BHOPAL,COLONEL KESARI SINGH,Independent,1840,0,1840,19
Madhya Pradesh,BHOPAL,GUNDESH KHAMBRA,Independent,681,0,681,20
Madhya Pradesh,BHOPAL,MAHANT GOPAL DAS BABA SHAHAB,Independent,570,0,570,21
Madhya Pradesh,BHOPAL,DANIEL JOHN,Independent,465,0,465,22
Madhya Pradesh,BHOPAL,PEEYUSH SONI,Independent,421,0,421,23
Madhya Pradesh,BHOPAL,PRABHAWATI SHAKYA KHOT,Independent,425,0,425,24
Madhya Pradesh,BHOPAL,BRAJENDRA GAPPU CHATURVEDI,Independent,684,0,684,25
Madhya Pradesh,BHOPAL,M C MITTAL JAI GURUDEO TATDHARI,Independent,620,0,620,26
Madhya Pradesh,BHOPAL,MEHBOOB KHAN,Independent,569,0,569,27
Madhya Pradesh,BHOPAL,SATISH BABU NAIDU,Independent,832,0,832,28
Madhya Pradesh,BHOPAL,None of the Above,NOTA,5181,0,5181,29
Madhya Pradesh,RAJGARH,AMLABE NARAYAN SINGH,Indian National Congress,367782,208,367990,1
Madhya Pradesh,RAJGARH,RODMAL NAGAR,Bharatiya Janata Party,596201,526,596727,2
Madhya Pradesh,RAJGARH,DR.SHIVNARAYAN VERMA,Bahujan Samaj Party,13853,11,13864,3
Madhya Pradesh,RAJGARH,DR.PRASHANT TRIPATHI,Aam Aadmi Party,8678,21,8699,4
Madhya Pradesh,RAJGARH,IMAMUDDIN KHAN,Independent,4333,1,4334,5
Madhya Pradesh,RAJGARH,ROD JI,Independent,8816,2,8818,6
Madhya Pradesh,RAJGARH,None of the Above,NOTA,10289,3,10292,7
Madhya Pradesh,DEWAS,GOKUL PRASAD DONGARE,Bahujan Samaj Party,17233,5,17238,1
Madhya Pradesh,DEWAS,MANOHAR UNTWAL,Bharatiya Janata Party,664985,661,665646,2
Madhya Pradesh,DEWAS,SAJJAN SINGH VERMA,Indian National Congress,405070,263,405333,3
Madhya Pradesh,DEWAS,KAMAL SINGH CHOUHAN,PRSP,16341,35,16376,4
Madhya Pradesh,DEWAS,SUJEET SANGTE,Aam Aadmi Party,4205,11,4216,5
Madhya Pradesh,DEWAS,SOBHAL SINGH SISODIYA,Samata Samadhan Party,1001,1,1002,6
Madhya Pradesh,DEWAS,SOUDAN SINGH DALMIYA,Bahujan Mukti Party,1505,4,1509,7
Madhya Pradesh,DEWAS,HEMRAJ SINGH BAMNIYA,BA S D,4655,4,4659,8
Madhya Pradesh,DEWAS,MANOHAR AHIRIYA,Independent,2763,0,2763,9
Madhya Pradesh,DEWAS,RADHESHYAM MALVIYA,Independent,4862,0,4862,10
Madhya Pradesh,DEWAS,SAJAN SINGH,Independent,10112,1,10113,11
Madhya Pradesh,DEWAS,None of the Above,NOTA,10250,3,10253,12
Madhya Pradesh,UJJAIN,PROF. CHINTAMANI MALVIYA,Bharatiya Janata Party,640751,350,641101,1
Madhya Pradesh,UJJAIN,PREMCHAND GUDDU,Indian National Congress,331263,175,331438,2
Madhya Pradesh,UJJAIN,RAMPRASAD JATWA,Bahujan Samaj Party,9965,4,9969,3
Madhya Pradesh,UJJAIN,ANIL PALE,BA S D,4439,0,4439,4
Madhya Pradesh,UJJAIN,ANEETA HINDOLIYA,Aam Aadmi Party,5904,13,5917,5
Madhya Pradesh,UJJAIN,NANDLAL CHAUHAN,Bahujan Mukti Party,925,2,927,6
Madhya Pradesh,UJJAIN,ER. BRAJMOHAN MALVIYA,PRSP,848,0,848,7
Madhya Pradesh,UJJAIN,BHAWARLAL TUFAN,Jai Maha Bharath Party,902,0,902,8
Madhya Pradesh,UJJAIN,RADHESHAYAM PANAVAR,All India Forward Bloc,1257,0,1257,9
Madhya Pradesh,UJJAIN,ASHOK,Independent,1669,0,1669,10
Madhya Pradesh,UJJAIN,LALCHAND GOMAY BERWA,Independent,2015,0,2015,11
Madhya Pradesh,UJJAIN,SURENDRA MEHAR,Independent,3635,1,3636,12
Madhya Pradesh,UJJAIN,None of the Above,NOTA,12284,3,12287,13
Madhya Pradesh,MANDSOUR,KRANTIPARIVARTAN,Bahujan Samaj Party,8099,5,8104,1
Madhya Pradesh,MANDSOUR,MEENAKSHI NATARAJAN,Indian National Congress,394470,216,394686,2
Madhya Pradesh,MANDSOUR,SUDHIR GUPTA,Bharatiya Janata Party,697620,715,698335,3
Madhya Pradesh,MANDSOUR,SHAIKH AZIZUDDIN QURAISHI,All India Forward Bloc,7990,2,7992,4
Madhya Pradesh,MANDSOUR,PARAS SAKLECHA DADA,Aam Aadmi Party,10155,28,10183,5
Madhya Pradesh,MANDSOUR,BANO BI,Bharatiya Minorities Suraksha Mahasangh,3441,0,3441,6
Madhya Pradesh,MANDSOUR,BANSHI LAL PATIDAR,BA S D,3501,0,3501,7
Madhya Pradesh,MANDSOUR,RAJU MALVIYA,Bahujan Mukti Party,1513,0,1513,8
Madhya Pradesh,MANDSOUR,ISMAILE MEW,Independent,1616,0,1616,9
Madhya Pradesh,MANDSOUR,NILESH TIWARI,Independent,1685,0,1685,10
Madhya Pradesh,MANDSOUR,PROF. PURUSHOTTAM MEGHWAL,Independent,2625,1,2626,11
Madhya Pradesh,MANDSOUR,MINAKSHI CHOUHAN,Independent,3151,0,3151,12
Madhya Pradesh,MANDSOUR,MINAKSHI PANDEY,Independent,8332,1,8333,13
Madhya Pradesh,MANDSOUR,SUDHIR GAUTAM,Independent,7613,2,7615,14
Madhya Pradesh,MANDSOUR,None of the Above,NOTA,8563,5,8568,15
Madhya Pradesh,RATLAM,KANTILAL BHURIA,Indian National Congress,437098,425,437523,1
Madhya Pradesh,RATLAM,DILEEPSINGH BHURIA,Bharatiya Janata Party,544453,1527,545980,2
Madhya Pradesh,RATLAM,BABUSINGH,Bahujan Samaj Party,18471,14,18485,3
Madhya Pradesh,RATLAM,COMRADE LATA BHABOR,Communist Party of India  (Marxist),6072,6,6078,4
Madhya Pradesh,RATLAM,ILIYAS BHAI MACHAR,MNDP,3581,0,3581,5
Madhya Pradesh,RATLAM,KAILASH VASUNIYA,Bahujan Mukti Party,3853,8,3861,6
Madhya Pradesh,RATLAM,BHERUSINGH DAMOR,Janata Dal (United),13108,8,13116,7
Madhya Pradesh,RATLAM,ENARI MACHAR,Aam Aadmi Party,6069,16,6085,8
Madhya Pradesh,RATLAM,BHADIYA DAWAR,Independent,6638,0,6638,9
Madhya Pradesh,RATLAM,MEENA ATUL DAVID,Independent,10979,0,10979,10
Madhya Pradesh,RATLAM,None of the Above,NOTA,30344,20,30364,11
Madhya Pradesh,DHAR,AJAY RAWAT,Bahujan Samaj Party,14661,5,14666,1
Madhya Pradesh,DHAR,UMANG SINGHAR,Indian National Congress,453805,254,454059,2
Madhya Pradesh,DHAR,SAVITRI THAKUR,Bharatiya Janata Party,557816,571,558387,3
Madhya Pradesh,DHAR,KARAN BURMAN GAREEB,Samata Samadhan Party,11481,0,11481,4
Madhya Pradesh,DHAR,BHERULAL IMLIYAR,Bahujan Mukti Party,3798,2,3800,5
Madhya Pradesh,DHAR,DR. HEMLATA JAMUNA DEVI,Aam Aadmi Party,10636,47,10683,6
Madhya Pradesh,DHAR,RAMA SINGH PATEL,Independent,8302,1,8303,7
Madhya Pradesh,DHAR,None of the Above,NOTA,15431,6,15437,8
Madhya Pradesh,INDORE,DHARAMDAS AHIRWAR,Bahujan Samaj Party,7416,6,7422,1
Madhya Pradesh,INDORE,SATYANARAYAN PATEL,Indian National Congress,387859,212,388071,2
Madhya Pradesh,INDORE,SUMITRA MAHAJAN (TAI),Bharatiya Janata Party,854326,646,854972,3
Madhya Pradesh,INDORE,ANIL TRIVEDI,Aam Aadmi Party,35124,45,35169,4
Madhya Pradesh,INDORE,P.T. JAGDISH CHANDRA BHATT,Jai Maha Bharath Party,1352,0,1352,5
Madhya Pradesh,INDORE,DR. NEHA SHARMA,Samajwadi Party,1619,0,1619,6
Madhya Pradesh,INDORE,MAMTA BHATI,RAHM,578,1,579,7
Madhya Pradesh,INDORE,RAMCHANDR PARMAR,Bahujan Mukti Party,477,0,477,8
Madhya Pradesh,INDORE,HARISH SAHU,Samata Samadhan Party,400,0,400,9
Madhya Pradesh,INDORE,AJEET KUMAR JAIN PATWA (DHARTI PAKAD),Independent,553,1,554,10
Madhya Pradesh,INDORE,GHANSHYAM CHANDEL,Independent,598,0,598,11
Madhya Pradesh,INDORE,JAMEELA BI,Independent,981,0,981,12
Madhya Pradesh,INDORE,MOMD.TANVEER,Independent,1576,0,1576,13
Madhya Pradesh,INDORE,PARMANAND TOLANI,Independent,1768,0,1768,14
Madhya Pradesh,INDORE,PRAVEEN KUMAR AJMERA JAIN,Independent,1867,0,1867,15
Madhya Pradesh,INDORE,MOHAMMAD IMTIYAZ KHAN,Independent,3862,0,3862,16
Madhya Pradesh,INDORE,RAVI SIRWAIYA,Independent,1356,0,1356,17
Madhya Pradesh,INDORE,RAKESH KUMAR PATEL,Independent,2528,0,2528,18
Madhya Pradesh,INDORE,RAMCHANDRA VASAINI (RAMA SETH),Independent,3725,0,3725,19
Madhya Pradesh,INDORE,SHAKTI SUDHA SHARMA,Independent,740,0,740,20
Madhya Pradesh,INDORE,SYED NIZAM AHMED,Independent,739,1,740,21
Madhya Pradesh,INDORE,SANTOSH KUMAR DEEN BANDHU,Independent,517,0,517,22
Madhya Pradesh,INDORE,None of the Above,NOTA,5935,9,5944,23
Madhya Pradesh,KHARGONE,COMRADE JYOTI GORE,Communist Party of India,25925,5,25930,1
Madhya Pradesh,KHARGONE,NAHARSINGH RICHHUJI BARDE,Bahujan Samaj Party,8261,5,8266,2
Madhya Pradesh,KHARGONE,RAMESH PATEL,Indian National Congress,391282,193,391475,3
Madhya Pradesh,KHARGONE,SUBHASH PATEL,Bharatiya Janata Party,648766,588,649354,4
Madhya Pradesh,KHARGONE,KAILASH AWASYA,Aam Aadmi Party,31216,6,31222,5
Madhya Pradesh,KHARGONE,GANGARAM PRATAP GAWLE,AMS,8544,0,8544,6
Madhya Pradesh,KHARGONE,KAILASH PATEL,Independent,7040,0,7040,7
Madhya Pradesh,KHARGONE,GAFFAR NOOR MO.,Independent,8553,0,8553,8
Madhya Pradesh,KHARGONE,None of the Above,NOTA,22135,6,22141,9
Madhya Pradesh,KHANDWA,ARUN SUBHASH CHANDRA YADAV,Indian National Congress,457184,459,457643,1
Madhya Pradesh,KHANDWA,NANDKUMAR SINGH CHOUHAN (NANDU BHAIYA),Bharatiya Janata Party,716164,1193,717357,2
Madhya Pradesh,KHANDWA,SANJAY S/O LAXMAN SOLANKI,Bahujan Samaj Party,13680,11,13691,3
Madhya Pradesh,KHANDWA,ALOK AGARWAL,Aam Aadmi Party,16765,34,16799,4
Madhya Pradesh,KHANDWA,ISHAMUDDIN (LEDAR) SAYYADH,Samata Party,1134,0,1134,5
Madhya Pradesh,KHANDWA,ZIAUDDIN INAMDAR,Bahujan Mukti Party,1073,2,1075,6
Madhya Pradesh,KHANDWA,BHAIYALAL UIKEY,Gondvana Gantantra Party,1203,5,1208,7
Madhya Pradesh,KHANDWA,DR. RAMESHSINGH - SOLANKI,PRSP,1235,0,1235,8
Madhya Pradesh,KHANDWA,VINOD KUMAR BHAGWAN BIRADE,Republican Party of India (A),1782,1,1783,9
Madhya Pradesh,KHANDWA,SHARIF RAJGEER,ABVCP,2252,3,2255,10
Madhya Pradesh,KHANDWA,KASHINATH UPADHYAY,Independent,2429,0,2429,11
Madhya Pradesh,KHANDWA,NANDLAL SINGH CHOUHAN (NANDU BHAIYA),Independent,5290,17,5307,12
Madhya Pradesh,KHANDWA,NANDLAL SINGH CHOUHAN,Independent,6223,3,6226,13
Madhya Pradesh,KHANDWA,BABA ABDUL HAMID,Independent,12036,0,12036,14
Madhya Pradesh,KHANDWA,None of the Above,NOTA,17146,3,17149,15
Madhya Pradesh,BETUL,"AJAY SHAH ""MAKRAI""",Indian National Congress,314901,136,315037,1
Madhya Pradesh,BETUL,JYOTI DHURVE,Bharatiya Janata Party,643318,333,643651,2
Madhya Pradesh,BETUL,SOHAN LAL UIKEY,Bahujan Samaj Party,16460,1,16461,3
Madhya Pradesh,BETUL,KALLUSHING KUMRE,Gondvana Gantantra Party,4545,1,4546,4
Madhya Pradesh,BETUL,GABBAR SINH WARKADE,Bahujan Mukti Party,3070,0,3070,5
Madhya Pradesh,BETUL,FAGRAM,Samajwadi Jan Parishad,4668,0,4668,6
Madhya Pradesh,BETUL,RAJESH SARIYAM,Aam Aadmi Party,20614,13,20627,7
Madhya Pradesh,BETUL,BHUPENDRA SINGH UIKEY,Independent,12933,0,12933,8
Madhya Pradesh,BETUL,None of the Above,NOTA,26722,4,26726,9
Maharashtra,Nandurbar ,GAVIT MANIKRAO HODLYA,Indian National Congress,471643,938,472581,1
Maharashtra,Nandurbar ,DR.GAVIT HEENA VIJAYKUMAR,Bharatiya Janata Party,578166,1320,579486,2
Maharashtra,Nandurbar ,VASAVE AMIT SHEKLAL,Bahujan Samaj Party,12128,5,12133,3
Maharashtra,Nandurbar ,ARJUNSING DIVANSING VASAVE,Bharipa Bahujan Mahasangha,4710,2,4712,4
Maharashtra,Nandurbar ,RANJIT JUGLA PADVI,Bahujan Mukti Party,3494,4,3498,5
Maharashtra,Nandurbar ,VIRENDRA RAVAJI VALVI,Aam Aadmi Party,3505,6,3511,6
Maharashtra,Nandurbar ,MAHESH JAYSING PAWARA,Independent,4387,2,4389,7
Maharashtra,Nandurbar ,C.S.VALVI,Independent,6004,0,6004,8
Maharashtra,Nandurbar ,ADV.SOBJI DEVALYA GAVIT,Independent,9184,0,9184,9
Maharashtra,Nandurbar ,None of the Above,NOTA,21163,15,21178,10
Maharashtra,Dhule,AMRISHBHAI RASIKLAL PATEL,Indian National Congress,397578,1149,398727,1
Maharashtra,Dhule,ISHI YOGESH YASHWANT,Bahujan Samaj Party,9885,12,9897,2
Maharashtra,Dhule,DR. BHAMRE SUBHASH RAMRAO,Bharatiya Janata Party,526821,2629,529450,3
Maharashtra,Dhule,ANSARI NIHAL AH. MOHD. HAROON,Aam Aadmi Party,9287,52,9339,4
Maharashtra,Dhule,JAGDANE RAMESH SOMA,MPS(T),828,0,828,5
Maharashtra,Dhule,NIHAL AH.AB.RAHEMAN DANEWALA,Samajwadi Party,1148,0,1148,6
Maharashtra,Dhule,MAHEMOOD BHAIJAAN,AwVP,792,0,792,7
Maharashtra,Dhule,SHAIKH MUKHATAR AH. MO. QASIM,Welfare Party of India,765,0,765,8
Maharashtra,Dhule,SAMBHAJI DEVIDAS PATIL,Bahujan Mukti Party,1147,2,1149,9
Maharashtra,Dhule,ABDUL HAMID SHAIKH HABIB,Independent,914,0,914,10
Maharashtra,Dhule,MO. ISMAIL JUMMAN,Independent,740,0,740,11
Maharashtra,Dhule,GAZI ATEZAD MUBEEN KHAN,Independent,788,0,788,12
Maharashtra,Dhule,JAFAR BAPUJI PATHAN,Independent,1355,0,1355,13
Maharashtra,Dhule,DEORE MAHENDRA TRYAMBAK,Independent,2091,0,2091,14
Maharashtra,Dhule,PINJARI JAYNUDDIN HUSEN,Independent,1545,0,1545,15
Maharashtra,Dhule,DR BHUPESH PRAKASH PATIL,Independent,6115,2,6117,16
Maharashtra,Dhule,RAMESH RAGHO MORE,Independent,8057,0,8057,17
Maharashtra,Dhule,SAYYAD MOHAMMAD QAYAM,Independent,1600,0,1600,18
Maharashtra,Dhule,SAYYAD SALIM SAYYAD ALIM,Independent,5278,0,5278,19
Maharashtra,Dhule,None of the Above,NOTA,2496,7,2503,20
Maharashtra,Jalgaon,A.T. NANA PATIL,Bharatiya Janata Party,647387,386,647773,1
Maharashtra,Jalgaon,BAGUL  V. T.(JIBHAU),Bahujan Samaj Party,10835,3,10838,2
Maharashtra,Jalgaon,ANNASAHEB DR.SATISH BHASKARRAO PATIL,Nationalist Congress Party,264151,97,264248,3
Maharashtra,Jalgaon,ABRAR BEG SARVAR BEG MIRZA,Republican Party of India,3212,0,3212,4
Maharashtra,Jalgaon,ADV. ASHOK DAGADU SHINDE,PRCP,1708,0,1708,5
Maharashtra,Jalgaon,ASHA SAHEBRAO PATIL,MPS(T),1578,1,1579,6
Maharashtra,Jalgaon,NANASO M.P. PAGARE,Rashtravadi Janata Party,1916,1,1917,7
Maharashtra,Jalgaon,MORE ISHWAR DAYARAM (EX-SERVICEMAN),Bahujan Mukti Party,2716,2,2718,8
Maharashtra,Jalgaon,RAGIB AHMED ABDUL NABI BAHADUR,Samajwadi Party,2675,0,2675,9
Maharashtra,Jalgaon,MAMASHRI SURESH PATIL (PATRAKAR),Hindustan Janta Party,958,0,958,10
Maharashtra,Jalgaon,DR. SANGRAM GOKULSINGH  PATIL,Aam Aadmi Party,7377,13,7390,11
Maharashtra,Jalgaon,ASHOK TARACHAND PATIL,Independent,5801,0,5801,12
Maharashtra,Jalgaon,IQBAL RAHEMAN DESHMUKH,Independent,2246,0,2246,13
Maharashtra,Jalgaon,PATIL SANDIP YUVRAJ,Independent,2879,0,2879,14
Maharashtra,Jalgaon,DR.MUBIN A. KHALIL A.,Independent,1676,0,1676,15
Maharashtra,Jalgaon,LALIT GAURISHANKAR SHARMA,Independent,8140,0,8140,16
Maharashtra,Jalgaon,VIJAY BHIMRAO NIKAM,Independent,9614,0,9614,17
Maharashtra,Jalgaon,SATISH BHASKAR PATIL (NANDGAON BK),Independent,6157,0,6157,18
Maharashtra,Jalgaon,SATISH BHASKAR PATIL (MUDI PRA DANGRI),Independent,3998,0,3998,19
Maharashtra,Jalgaon,SATISH BHASKAR PATIL (VARKHEDI),Independent,1537,0,1537,20
Maharashtra,Jalgaon,None of the Above,NOTA,3260,8,3268,21
Maharashtra,Raver,KHADASE RAKSHA NIKHIL,Bharatiya Janata Party,605064,388,605452,1
Maharashtra,Raver,BHANDE DASHRATH MOTIRAM,Bahujan Samaj Party,29746,6,29752,2
Maharashtra,Raver,MANISHDADA JAIN,Nationalist Congress Party,287271,113,287384,3
Maharashtra,Raver,KHATIK MOHAMMAD HAROON,Samajwadi Party,4374,2,4376,4
Maharashtra,Raver,GAIKWAD BHAGWAN MADHAV,PRCP,1206,0,1206,5
Maharashtra,Raver,MANYAR SHE. SAJID SHE. KADAR,MNDP,1606,0,1606,6
Maharashtra,Raver,RAJEEV SATYENDRA SHARMA,Aam Aadmi Party,3751,5,3756,7
Maharashtra,Raver,WAMANRAO MADHAV SASANE,Bahujan Mukti Party,1753,4,1757,8
Maharashtra,Raver,SHAIKH MO. ASGAR SAKHAWAT,Republican Party of India,821,0,821,9
Maharashtra,Raver,DNYANESHWAR AMALE-PATIL,All India Forward Bloc,1220,0,1220,10
Maharashtra,Raver,ASHOK TRYAMBAK INGALE,Independent,1131,0,1131,11
Maharashtra,Raver,DR. ULHAS VASUDEO PATIL,Independent,21321,11,21332,12
Maharashtra,Raver,KADRI SANIYA SAIYED ALI,Independent,2657,1,2658,13
Maharashtra,Raver,GOVINDA NARAYAN GUNJAL,Independent,2844,0,2844,14
Maharashtra,Raver,ZAGADYA PURMYA PAWARA,Independent,3707,0,3707,15
Maharashtra,Raver,MANISHDADA SATISH JAIN,Independent,14599,0,14599,16
Maharashtra,Raver,MOHAN SHAMRAO CHAVHAN (MANOJSIR VARDIKAR),Independent,8797,0,8797,17
Maharashtra,Raver,D.D.WANI (PHOTOGRAPHER) (DNYANESHWAR DIVAKAR WANI),Independent,3348,1,3349,18
Maharashtra,Raver,SHAIKH SHAKIR,Independent,4009,0,4009,19
Maharashtra,Raver,SHAIKH SHAHERA BI. JAINODDIN SHAIKH,Independent,1375,0,1375,20
Maharashtra,Raver,J.G.SURWADE,Independent,1634,0,1634,21
Maharashtra,Raver,SURESH HIRAMAN INGALE,Independent,1258,0,1258,22
Maharashtra,Raver,SONAWANE VANDANA SHIVAJI,Independent,978,0,978,23
Maharashtra,Raver,None of the Above,NOTA,4211,1,4212,24
Maharashtra,Buldhana,ABDUL  HAFEEZ ABDUL AZIZ,Bahujan Samaj Party,33777,6,33783,1
Maharashtra,Buldhana,INGLE KRUSHANARAO GANPATRAO,Nationalist Congress Party,349534,32,349566,2
Maharashtra,Buldhana,JADHAV PRATAPRAO GANPATRAO,Shivsena,508972,173,509145,3
Maharashtra,Buldhana,PARMESHWAR HIRAMAN GAWAI,ARP,6983,0,6983,4
Maharashtra,Buldhana,SMT. PRABHATAI MADHUKAR PARLEWAR,NRSN,1725,0,1725,5
Maharashtra,Buldhana,ADV. RAVINDRA DNYANDEO BHOJANE,APoI,2448,0,2448,6
Maharashtra,Buldhana,RAVINDRASING RAMSING PAWAR,LB,1265,0,1265,7
Maharashtra,Buldhana,VASANTRAO SUKHDEV DANDAGE,Samajwadi Party,2750,0,2750,8
Maharashtra,Buldhana,SUDHIR BABAN SURVE,Aam Aadmi Party,3423,6,3429,9
Maharashtra,Buldhana,SANDESH ASHOK AMBEDKAR,Bahujan Mukti Party,7923,4,7927,10
Maharashtra,Buldhana,COMMANDER (RTD) ASHOK  RAUT,Independent,2077,0,2077,11
Maharashtra,Buldhana,KRUSHNARAO INGLE,Independent,1785,2,1787,12
Maharashtra,Buldhana,CHINCHOLE GANGARAM KALUJI,Independent,1917,0,1917,13
Maharashtra,Buldhana,NAMDEO PUNDLIK DONGARDIVE,Independent,6959,0,6959,14
Maharashtra,Buldhana,BALASAHEB SHANKAR DARADE,Independent,29783,10,29793,15
Maharashtra,Buldhana,SANJAY MAHADEV WANKHADE,Independent,4519,1,4520,16
Maharashtra,Buldhana,SAMBARE DINKAR TUKARAM,Independent,2006,0,2006,17
Maharashtra,Buldhana,None of the Above,NOTA,10546,0,10546,18
Maharashtra,Akola,BHAI B.C. KAMBLE,Bahujan Samaj Party,7855,3,7858,1
Maharashtra,Akola,DHOTRE SANJAY SHAMRAO,Bharatiya Janata Party,455996,476,456472,2
Maharashtra,Akola,PATEL HIDAYAT ULLA BARKAT ULLA,Indian National Congress,253055,301,253356,3
Maharashtra,Akola,AJAY PANJABRAO HINGANKAR,Aam Aadmi Party,8069,7,8076,4
Maharashtra,Akola,AMBEDKAR PRAKASH YASHWANT,Bharipa Bahujan Mahasangha,238669,107,238776,5
Maharashtra,Akola,SHAIKH HAMEED IMAM,Bahujan Mukti Party,3989,2,3991,6
Maharashtra,Akola,SANDIP KISANRAO WANKHEDE,Independent,3756,0,3756,7
Maharashtra,Akola,None of the Above,NOTA,6200,6,6206,8
Maharashtra,Amravati ,ADSUL ANANDRAO VITHOBA,Shivsena,465363,1849,467212,1
Maharashtra,Amravati ,GUNWANT SUDAMRAO DEVPARE,Bahujan Samaj Party,97928,272,98200,2
Maharashtra,Amravati ,NAVNEET RAVI RANA,Nationalist Congress Party,328556,724,329280,3
Maharashtra,Amravati ,JYOTI GAJANAN MAKODE,APoI,3719,5,3724,4
Maharashtra,Amravati ,BHAVNA BHAVESH WASNIK,Aam Aadmi Party,6383,41,6424,5
Maharashtra,Amravati ,DR.RAJENDRA RAMKRISHNA GAWAI,Republican Party of India,54204,74,54278,6
Maharashtra,Amravati ,RAMTEKE RAMESH DEVIDASRAO,Republican Party of India (Khobragade),1441,1,1442,7
Maharashtra,Amravati ,SUNIL DAVID AMRAVATI,Bahujan Mukti Party,1461,2,1463,8
Maharashtra,Amravati ,ATHAWALEY SANJAY HIRAMANJI,Independent,1649,0,1649,9
Maharashtra,Amravati ,ASHATAI ABHYANKAR AMRAVATI,Independent,809,0,809,10
Maharashtra,Amravati ,KIRANTAI DADARAO ALIAS KOKUBHAU KOKATE,Independent,970,0,970,11
Maharashtra,Amravati ,JYOTI SANJAY DEWKAR,Independent,1312,0,1312,12
Maharashtra,Amravati ,DONGRE PRIYA ANIL,Independent,1734,0,1734,13
Maharashtra,Amravati ,ADV. BANDYA SANE ALIAS BANDU SAMPATRAO SANE,Independent,3731,1,3732,14
Maharashtra,Amravati ,MANOHAR BALIRAM SONONE,Independent,2489,0,2489,15
Maharashtra,Amravati ,RAJU MAHADEORAO SONONE,Independent,10052,0,10052,16
Maharashtra,Amravati ,RAJU S. MANKAR,Independent,7873,0,7873,17
Maharashtra,Amravati ,VISHWANATH GOTUJI JAMNEKAR,Independent,2011,0,2011,18
Maharashtra,Amravati ,SIRSAT HARIDAS ANKUSH,Independent,5266,2,5268,19
Maharashtra,Amravati ,None of the Above,NOTA,4112,27,4139,20
Maharashtra,Wardha,CHETAN BHIMRAJ PENDAM,Bahujan Samaj Party,90792,74,90866,1
Maharashtra,Wardha,MEGHE SAGAR DATTATRAYA,Indian National Congress,321330,405,321735,2
Maharashtra,Wardha,RAMDAS CHANDRABHANJI TADAS,Bharatiya Janata Party,536778,740,537518,3
Maharashtra,Wardha,UBALE SHRIKRUSHNA CHAMPATRAO,ARP,6394,11,6405,4
Maharashtra,Wardha,DR. ANKUSH VIJAYRAO NAWALE,Samajwadi Party,1851,7,1858,5
Maharashtra,Wardha,KISHOR RAMBHAU KINKAR,Bahujan Mukti Party,2516,2,2518,6
Maharashtra,Wardha,NARENDRA CHINDUJI MESHRAM,Gondvana Gantantra Party,2626,1,2627,7
Maharashtra,Wardha,MOHD. ALIM PATEL MOHD. WAHID,Aam Aadmi Party,15719,19,15738,8
Maharashtra,Wardha,ARVIND SHAMRAO LILLORE,Independent,614,0,614,9
Maharashtra,Wardha,JAGDISH BHAGWAN KADU,Independent,853,0,853,10
Maharashtra,Wardha,TADAS VILAS KRUSHNAJI,Independent,2124,0,2124,11
Maharashtra,Wardha,DEEPAKSINGH TRYAMBAKRAO DESHMUKH,Independent,1122,0,1122,12
Maharashtra,Wardha,DESHMUKH JAIDEEP RAJENDRA,Independent,1431,0,1431,13
Maharashtra,Wardha,BHASKAR MAROTRAO NEWARE,Independent,3155,1,3156,14
Maharashtra,Wardha,MANISH VINAYAKRAO TELRANDHE,Independent,5127,0,5127,15
Maharashtra,Wardha,RAVI ALIAS SHAILESH GANESHRAO YELNE,Independent,3881,0,3881,16
Maharashtra,Wardha,RAUT JAGANATH NILKANTH,Independent,2638,0,2638,17
Maharashtra,Wardha,SHAMBABA ALIAS SHAMSUNDAR PANJABRAO NICHIT,Independent,3439,1,3440,18
Maharashtra,Wardha,SHAMBHARKAR RAJENDRA GULABRAO,Independent,4436,0,4436,19
Maharashtra,Wardha,SACHIN PANDURANGJI RAUT ALIAS GURUBHAU,Independent,1245,0,1245,20
Maharashtra,Wardha,SANJAYBHAU NARAYANRAO CHIDAM,Independent,769,1,770,21
Maharashtra,Wardha,None of the Above,NOTA,3338,5,3343,22
Maharashtra,Ramtek ,KIRAN PREM KUMAR RODGE (PATANKAR),Bahujan Samaj Party,94991,60,95051,1
Maharashtra,Ramtek ,KRUPAL BALAJI TUMANE,Shivsena,519214,678,519892,2
Maharashtra,Ramtek ,MUKUL WASNIK,Indian National Congress,343886,215,344101,3
Maharashtra,Ramtek ,GANESH BAPURAO PATIL,Gondvana Gantantra Party,6219,3,6222,4
Maharashtra,Ramtek ,CHAWARE MAYA NAMDEO,Samajwadi Party,2681,1,2682,5
Maharashtra,Ramtek ,NARESH MAHADEO PATIL,Bahujan Mukti Party,2839,2,2841,6
Maharashtra,Ramtek ,PANKAJ SEWAKRAM MASURKAR,Hindustan Janta Party,1450,3,1453,7
Maharashtra,Ramtek ,PRATAP GOSWAMI,Aam Aadmi Party,25837,52,25889,8
Maharashtra,Ramtek ,COM. BANDU RAMCHANDRA MESHRAM,Communist Party of India (Marxist),1602,0,1602,9
Maharashtra,Ramtek ,DHIMATI VIDYA KISHOR BHIMTE,APoI,3631,3,3634,10
Maharashtra,Ramtek ,SANDESH BHIVRAM BHALEKAR,All India Forward Bloc,2424,0,2424,11
Maharashtra,Ramtek ,DR. SUNILBHAU VISHWANATHJI NARNAVRE,Republican Party of India (Khobragade),2309,1,2310,12
Maharashtra,Ramtek ,DR. SANDEEP NATTHUJI NANDESHWAR,Bharipa Bahujan Mahasangha,2638,2,2640,13
Maharashtra,Ramtek ,KHOBRAGADE CHANDRABHAN JAIRAM,Independent,2925,0,2925,14
Maharashtra,Ramtek ,GURUDAS UDDHAV BAWANE,Independent,3417,2,3419,15
Maharashtra,Ramtek ,GOUTAM SHRIRAM WASNIK,Independent,6352,1,6353,16
Maharashtra,Ramtek ,DONGRE ASHOK NAMAJI,Independent,3999,0,3999,17
Maharashtra,Ramtek ,TUMANE GOPAL AJABRAO,Independent,6303,1,6304,18
Maharashtra,Ramtek ,PROF. DR. NATTHU MADHAO LOKHANDE,Independent,4756,0,4756,19
Maharashtra,Ramtek ,NILESH MAHADEO DHOKE,Independent,2535,2,2537,20
Maharashtra,Ramtek ,RAHUL SHESHRAOJI MESHRAM,Independent,1189,0,1189,21
Maharashtra,Ramtek ,RAHULKANT ALIAS RAMESH SINHA,Independent,1542,0,1542,22
Maharashtra,Ramtek ,LOKHANDE GANESH HAIBATRAO,Independent,1735,0,1735,23
Maharashtra,Ramtek ,None of the Above,NOTA,4804,12,4816,24
Maharashtra,Nagpur ,GADKARI NITIN JAIRAM,Bharatiya Janata Party,586857,910,587767,1
Maharashtra,Nagpur ,DR.  MOHAN RAMRAO GAIKWAD,Bahujan Samaj Party,96331,102,96433,2
Maharashtra,Nagpur ,VILAS MUTTEMWAR,Indian National Congress,302618,301,302919,3
Maharashtra,Nagpur ,ANJALI ANISH DAMANIA,Aam Aadmi Party,68982,99,69081,4
Maharashtra,Nagpur ,ANSARI JAVED AHEMAD,DESEP,1261,1,1262,5
Maharashtra,Nagpur ,CHIMOTE RAMMURTI KESHVRAO,Gondvana Gantantra Party,526,2,528,6
Maharashtra,Nagpur ,DR. DHARMENDRA  MANDLIK (PARATE),Hindustan Janta Party,425,1,426,7
Maharashtra,Nagpur ,DR. PRADEEP RAMBHAUJI  NAGRALE,APoI,1364,2,1366,8
Maharashtra,Nagpur ,PHUSEY GHANSHYAM RAMAJI,Republican Party of India,654,1,655,9
Maharashtra,Nagpur ,BASHIR KHAN,MNDP,466,0,466,10
Maharashtra,Nagpur ,SHAHID SHARIF,Janata Dal (United),452,0,452,11
Maharashtra,Nagpur ,SUNIL DATTU PENDOR,Bahujan Mukti Party,835,1,836,12
Maharashtra,Nagpur ,ATEEQUE AHMAD MALIK,Independent,373,0,373,13
Maharashtra,Nagpur ,ANITA NAGDIGAMBAR TEKAM,Independent,659,1,660,14
Maharashtra,Nagpur ,AJAZ KHAN,Independent,542,0,542,15
Maharashtra,Nagpur ,KAVITA VINODKUMAR TIBDIWAL,Independent,2408,0,2408,16
Maharashtra,Nagpur ,KANPHADE RAJENDRAKUMAR  EX. ADDITIONAL COLLECTOR,Independent,2267,2,2269,17
Maharashtra,Nagpur ,GAUS MOHAMMED SHEIKH AYYUB SHEIKH,Independent,784,0,784,18
Maharashtra,Nagpur ,CHANDA  SUDHIR MANWATKAR,Independent,1879,1,1880,19
Maharashtra,Nagpur ,JIVAN RAMTEKE,Independent,807,0,807,20
Maharashtra,Nagpur ,DILIP NARAYAN BHORKAR,Independent,415,0,415,21
Maharashtra,Nagpur ,DHIRAJ JAIDEV GAJBHIYE,Independent,390,0,390,22
Maharashtra,Nagpur ,PANKAJ PRAFULKUMAR BHANSALI,Independent,439,0,439,23
Maharashtra,Nagpur ,BABURAO DAMADUJI MESHRAM,Independent,538,1,539,24
Maharashtra,Nagpur ,BABULAL SUNDARLAL BANJARE,Independent,419,0,419,25
Maharashtra,Nagpur ,MOHAN MAROTRAO KAREMORE,Independent,665,0,665,26
Maharashtra,Nagpur ,RAVINDRA MANIK BORKAR,Independent,760,0,760,27
Maharashtra,Nagpur ,RAJESH SURESH SADHANKAR,Independent,536,1,537,28
Maharashtra,Nagpur ,SHAKIL WASI AHAMAD,Independent,542,0,542,29
Maharashtra,Nagpur ,SHRIDHAR NARAYAN SALVE,Independent,1187,0,1187,30
Maharashtra,Nagpur ,ADV. SURESH  SHINDE,Independent,677,0,677,31
Maharashtra,Nagpur ,SENAPATI UTTAM SAPAN,Independent,2017,0,2017,32
Maharashtra,Nagpur ,SOMKUVAR VIJAY SITARAM,Independent,1077,0,1077,33
Maharashtra,Nagpur ,None of the Above,NOTA,3452,8,3460,34
Maharashtra,Bhandara - gondiya,NANABHAU FALGUNRAO PATOLE,Bharatiya Janata Party,605686,443,606129,1
Maharashtra,Bhandara - gondiya,PATEL PRAFUL MANOHARBHAI,Nationalist Congress Party,456450,425,456875,2
Maharashtra,Bhandara - gondiya,ENG. SANJAY RAGHUNATH NASARE,Bahujan Samaj Party,50943,15,50958,3
Maharashtra,Bhandara - gondiya,DR.KOHAPARE HARSHAWARDHAN MUNESHWAR,Bahujan Mukti Party,1542,2,1544,4
Maharashtra,Bhandara - gondiya,JITENDRA AADKUJI RAUT,ABMP,1077,0,1077,5
Maharashtra,Bhandara - gondiya,THAKARE RAMESHWAR (RAMESHWAR) SUNDARLAL,Samajwadi Party,1259,1,1260,6
Maharashtra,Bhandara - gondiya,DAHARWAL GANESHDEO RAGHUJI,Gondvana Gantantra Party,1541,1,1542,7
Maharashtra,Bhandara - gondiya,PATLE ANJALI AGASTIKUMAR,Bharipa Bahujan Mahasangha,1955,0,1955,8
Maharashtra,Bhandara - gondiya,PRASHANT SHYAMSUNDAR MISHRA,Aam Aadmi Party,8636,11,8647,9
Maharashtra,Bhandara - gondiya,RAMAN MOTIRAM BANSOD,APoI,1428,1,1429,10
Maharashtra,Bhandara - gondiya,RANJEET AMARDAS SUKHDEVE,Ambedkar Samaj Party,987,0,987,11
Maharashtra,Bhandara - gondiya,SAYYAD AFJALALI ALIAS CHHANUBHAI,MNDP,1577,1,1578,12
Maharashtra,Bhandara - gondiya,ARUN NAGORAO GAJBHIYE,Independent,1876,0,1876,13
Maharashtra,Bhandara - gondiya,ISHWAR LAHANU NANDAGAWALI,Independent,5941,0,5941,14
Maharashtra,Bhandara - gondiya,CHOLE OMPRAKASH BAKARAM,Independent,4417,0,4417,15
Maharashtra,Bhandara - gondiya,ZANZAD SHALIKRAM SHANKARRAO,Independent,9736,0,9736,16
Maharashtra,Bhandara - gondiya,ADV.DADASAHEB ALIAS DHANU BHIKAJI WALTHARE,Independent,10133,0,10133,17
Maharashtra,Bhandara - gondiya,DHANANJAY SHAMLALJI RAJABHOJ,Independent,6128,0,6128,18
Maharashtra,Bhandara - gondiya,BANTE JITENDRA RAMAJI,Independent,1729,0,1729,19
Maharashtra,Bhandara - gondiya,MATE MANOHAR ALIAS MAMA,Independent,1380,0,1380,20
Maharashtra,Bhandara - gondiya,MIRZA VAHED BEG AHMADBEG,Independent,899,0,899,21
Maharashtra,Bhandara - gondiya,MORESHWAR RAMAJI MESHRAM,Independent,10124,3,10127,22
Maharashtra,Bhandara - gondiya,VARSHA GOVIND TIDKE,Independent,594,0,594,23
Maharashtra,Bhandara - gondiya,WADHAVE DAMODHAR NATTHU,Independent,577,0,577,24
Maharashtra,Bhandara - gondiya,VISHAL ARVIND BHOYAR,Independent,4169,0,4169,25
Maharashtra,Bhandara - gondiya,SUSHMA VITTHAL NAGPURE,Independent,1477,0,1477,26
Maharashtra,Bhandara - gondiya,None of the Above,NOTA,4030,2,4032,27
Maharashtra,Gadchiroli-Chimur,ASHOK MAHADEORAO NETE,Bharatiya Janata Party,535616,366,535982,1
Maharashtra,Gadchiroli-Chimur,NAMDEO ANANDRAO KANNAKE,Communist Party of India,22510,2,22512,2
Maharashtra,Gadchiroli-Chimur,DR. NAMDEO DALLUJI USENDI,Indian National Congress,298976,136,299112,3
Maharashtra,Gadchiroli-Chimur,RAMRAO GOVINDA NANNAWARE,Bahujan Samaj Party,66877,29,66906,4
Maharashtra,Gadchiroli-Chimur,DR. GAJBE RAMESHKUMAR BABURAOJI,Aam Aadmi Party,45421,37,45458,5
Maharashtra,Gadchiroli-Chimur,DIWAKAR PENDAM (EX. SERVICEMAN),Bahujan Mukti Party,3728,2,3730,6
Maharashtra,Gadchiroli-Chimur,DEORAO MONBA NANNAWARE,APoI,6605,1,6606,7
Maharashtra,Gadchiroli-Chimur,ADV. PRABHAKAR MAHAGUJI DADMAL,Republican Party of India,3420,2,3422,8
Maharashtra,Gadchiroli-Chimur,VINOD ANKUSH NANNAWARE,Samajwadi Party,4286,1,4287,9
Maharashtra,Gadchiroli-Chimur,SATISH GOKULDAS PENDAM,All India Trinamool Congress,8155,1,8156,10
Maharashtra,Gadchiroli-Chimur,DANDEKAR BABURAO LAXMAN,Independent,6470,0,6470,11
Maharashtra,Gadchiroli-Chimur,None of the Above,NOTA,24479,9,24488,12
Maharashtra,Chandrapur,AHIR HANSRAJ GANGARAM,Bharatiya Janata Party,507503,546,508049,1
Maharashtra,Chandrapur,KUMBHARE HANSRAJ GULAB,Bahujan Samaj Party,49188,41,49229,2
Maharashtra,Chandrapur,DEOTALE SANJAY WAMANRAO,Indian National Congress,271617,163,271780,3
Maharashtra,Chandrapur,ASHOK VITHOBA KHANDALE,Republican Party of India,8301,1,8302,4
Maharashtra,Chandrapur,QURESHI M. EKHALAK M. YUSUF,Socialist Party (India),4176,0,4176,5
Maharashtra,Chandrapur,GHAYWAN ROSHAN JAMBUWANTRAO,Republican Paksha (Khoripa),2735,1,2736,6
Maharashtra,Chandrapur,CHATAP WAMANRAO SADASHIV,Aam Aadmi Party,204192,221,204413,7
Maharashtra,Chandrapur,NITIN VASANT POHANE,LB,3772,0,3772,8
Maharashtra,Chandrapur,NANDKISHOR GANGARAM RANGARI,APoI,4850,0,4850,9
Maharashtra,Chandrapur,PANKAJKUMAR  SHARMA,All India Trinamool Congress,3216,0,3216,10
Maharashtra,Chandrapur,FIRAJ  PATHAN,Bahujan Mukti Party,4326,15,4341,11
Maharashtra,Chandrapur,SIDDHARTH  RAUT,PRCP,2188,0,2188,12
Maharashtra,Chandrapur,ATUL ASHOK MUNGINWAR,Independent,2693,0,2693,13
Maharashtra,Chandrapur,KARTIK GAJANAN KODAPE,Independent,3879,0,3879,14
Maharashtra,Chandrapur,NAMDEO  SHEDMAKE,Independent,5829,0,5829,15
Maharashtra,Chandrapur,PRAMOD MANGARUJI SORTE,Independent,10930,0,10930,16
Maharashtra,Chandrapur,VINOD DINANATH MESHRAM,Independent,8935,1,8936,17
Maharashtra,Chandrapur,SANJAY NILKANTH GAWANDE,Independent,2167,0,2167,18
Maharashtra,Chandrapur,None of the Above,NOTA,8252,5,8257,19
Maharashtra,Yavatmal-Washim,GAWALI BHAVANA PUNDLIKRAO,Shivsena,476930,975,477905,1
Maharashtra,Yavatmal-Washim,RAJU OR BHARATRAJE UDDHAORAO PATIL,MNS,26175,19,26194,2
Maharashtra,Yavatmal-Washim,RATHOD BALIRAM PARASHRAM,Bahujan Samaj Party,48895,86,48981,3
Maharashtra,Yavatmal-Washim,ADV.SHIVAJIRAO SHIVARAMJI MOGHE,Indian National Congress,383639,450,384089,4
Maharashtra,Yavatmal-Washim,ABRAR AHMAD MAHMUD KHAN,Welfare Party of India,5670,2,5672,5
Maharashtra,Yavatmal-Washim,AHMAD PARVEZ IQBAL AHMAD NUR MOHAMMAD,Samajwadi Party,3259,3,3262,6
Maharashtra,Yavatmal-Washim,KAMBLE UTTAM BHAGAJI,PRCP,1402,0,1402,7
Maharashtra,Yavatmal-Washim,DHOTE JAMBUWANTRAO BAPURAO,All India Forward Bloc,4704,4,4708,8
Maharashtra,Yavatmal-Washim,RAGHUNATH SHANKARRAO SHELKE,ARP,1910,1,1911,9
Maharashtra,Yavatmal-Washim,RATHOD INDUWAR KASHIRAM,Bahujan Mukti Party,4617,10,4627,10
Maharashtra,Yavatmal-Washim,RATHOD NARESH FULSING,Aam Aadmi Party,6404,19,6423,11
Maharashtra,Yavatmal-Washim,RATHOD MOHAN MALLU,Bharipa Bahujan Mahasangha,22115,28,22143,12
Maharashtra,Yavatmal-Washim,SAWAKE RAMKRUSHNA PUNDLIKRAO,Communist Party of India (Marxist),2193,0,2193,13
Maharashtra,Yavatmal-Washim,SUDHAKAR NAMDEORAO GHAYAWAN,Republican Party of India (Khobragade),3602,0,3602,14
Maharashtra,Yavatmal-Washim,SURESH RAJARAM MUKHMALE,MVA,2129,1,2130,15
Maharashtra,Yavatmal-Washim,ULHAS VASRAMJI JADHAO,Independent,7166,0,7166,16
Maharashtra,Yavatmal-Washim,GAIKAWAD RAJENDRA VITTHAL,Independent,7482,0,7482,17
Maharashtra,Yavatmal-Washim,GURNULE RAMESH VITHOBA,Independent,2484,0,2484,18
Maharashtra,Yavatmal-Washim,CHAVAN VINOD NARAYAN,Independent,2177,0,2177,19
Maharashtra,Yavatmal-Washim,NARESH MAHADEORAO GUGHANE,Independent,3422,0,3422,20
Maharashtra,Yavatmal-Washim,PRAKASH RAGHUNATH RAUT,Independent,2514,0,2514,21
Maharashtra,Yavatmal-Washim,PRASHANT PANDHARINATH SURVE,Independent,1558,0,1558,22
Maharashtra,Yavatmal-Washim,PATIL UPENDRA BABARAO,Independent,895,0,895,23
Maharashtra,Yavatmal-Washim,MESHRAM DNYANESHWAR TUKARAM,Independent,1036,0,1036,24
Maharashtra,Yavatmal-Washim,SHYAMKUMAR BAPURAO LOKHANDE,Independent,1218,0,1218,25
Maharashtra,Yavatmal-Washim,SHAIKH JABBAR SHAIKH USUF,Independent,2172,0,2172,26
Maharashtra,Yavatmal-Washim,None of the Above,NOTA,5571,12,5583,27
Maharashtra,Hingoli ,JADHAV CHUNNILAL MOHAN,Bahujan Samaj Party,25124,21,25145,1
Maharashtra,Hingoli ,D.B.NAIK,Communist Party of India  (Marxist),14983,3,14986,2
Maharashtra,Hingoli ,RAJEEV SHANKARRAO SATAV,Indian National Congress,466483,914,467397,3
Maharashtra,Hingoli ,WANKHEDE SUBHASH BAPURAO,Shivsena,464729,1036,465765,4
Maharashtra,Hingoli ,UTTAMRAO PANDURANG RATHOD,Bahujan Mukti Party,9743,27,9770,5
Maharashtra,Hingoli ,DESAI PANDURANG DEVRAO,Janata Dal (Secular),1675,0,1675,6
Maharashtra,Hingoli ,RAMRAO HARISING RATHOD,Bharipa Bahujan Mahasangha,9562,15,9577,7
Maharashtra,Hingoli ,WANKHEDE SUBHASH NAGORAO,Janata Dal (United),6278,6,6284,8
Maharashtra,Hingoli ,PRINCIPAL DR.VITHAL NAMDEORAO KADAM,Aam Aadmi Party,3705,24,3729,9
Maharashtra,Hingoli ,SHAIKH NAYEEM SHAIKH LAL,Samajwadi Party,2514,0,2514,10
Maharashtra,Hingoli ,SANTOSH NAMDEORAO SAGNE,AwVP,1526,0,1526,11
Maharashtra,Hingoli ,UTTAM RATHOD,Independent,2146,1,2147,12
Maharashtra,Hingoli ,GHUNNAR PRAKASH VITTHALRAO,Independent,2497,0,2497,13
Maharashtra,Hingoli ,DEVJI GANGARAM ASOLE,Independent,3165,0,3165,14
Maharashtra,Hingoli ,DESHMUKH BALASAHEB DESAI,Independent,2154,0,2154,15
Maharashtra,Hingoli ,DHABE UTTAM MAROTI,Independent,7878,0,7878,16
Maharashtra,Hingoli ,NAIKWADE DIGAMBAR GUNAJI,Independent,2049,0,2049,17
Maharashtra,Hingoli ,BHAROSE ANANT RAMRAO,Independent,2506,0,2506,18
Maharashtra,Hingoli ,WANKHEDE SUBHASH,Independent,6146,11,6157,19
Maharashtra,Hingoli ,SATAV ATMARAM RAGHOJI,Independent,4993,7,5000,20
Maharashtra,Hingoli ,SATAV RAJU SHANKAR,Independent,3514,8,3522,21
Maharashtra,Hingoli ,SURYAWANSHI ASHOK BHAGWANRAO,Independent,1292,0,1292,22
Maharashtra,Hingoli ,SURAJ VISHWANATH KONDARWAD,Independent,1322,0,1322,23
Maharashtra,Hingoli ,None of the Above,NOTA,3101,6,3107,24
Maharashtra,Nanded,ASHOK SHANKARRAO CHAVAN,Indian National Congress,491292,1783,493075,1
Maharashtra,Nanded,D. B. PATIL,Bharatiya Janata Party,410454,1166,411620,2
Maharashtra,Nanded,DR. HANSRAJ DADARAOJI VAIDYA,Bahujan Samaj Party,22772,37,22809,3
Maharashtra,Nanded,ALTAF AHMED IQBAL AHMED,Indian Union Muslim League,1545,2,1547,4
Maharashtra,Nanded,GRANTHI NARENDRASINGH ANMOLSINGH,Aam Aadmi Party,3382,15,3397,5
Maharashtra,Nanded,RAJRATNA AMBEDKAR,Bahujan Mukti Party,28396,51,28447,6
Maharashtra,Nanded,RAMCHANDRA GYANOBA SAWANT,Bharipa Bahujan Mahasangha,4196,10,4206,7
Maharashtra,Nanded,SHINDE BALAJI VISHWANATHRAO,Samajwadi Party,1723,1,1724,8
Maharashtra,Nanded,SHAIKH AFZALUDDIN AZEEMUDDIN,LB,1065,0,1065,9
Maharashtra,Nanded,SAYYED TANVEER SAYYADHAMAJA,Majlis Bachao Tahreek,1287,1,1288,10
Maharashtra,Nanded,GHUNNAR PRAKASH VITHALRAO,Independent,1753,0,1753,11
Maharashtra,Nanded,DATTARAM BALAJI SURWANSHI,Independent,2882,0,2882,12
Maharashtra,Nanded,ADV. DEELIP PRABHAKARRAO KULKARNI (PHULWALKAR),Independent,1285,0,1285,13
Maharashtra,Nanded,ADV. DHONDOPANT NAGORAO HANUMANTE,Independent,1473,0,1473,14
Maharashtra,Nanded,PATHAN ZAFAR ALIKHAN MEHMOOD ALIKHAN,Independent,1993,0,1993,15
Maharashtra,Nanded,PANJABRAO SHRIHARI WADJE PATIL,Independent,5825,0,5825,16
Maharashtra,Nanded,FEROZ KHAN GAZI,Independent,8076,12,8088,17
Maharashtra,Nanded,BOCHARE SHANKAR MAHADJI,Independent,5694,0,5694,18
Maharashtra,Nanded,MOHD. MAROOF AB. RAUF,Independent,4771,0,4771,19
Maharashtra,Nanded,RAMCHANDRA GANGARAM  BHARANDE,Independent,3064,3,3067,20
Maharashtra,Nanded,VENUGOPAL SHASTRI TUMULURI S/O RAMKRISHNA,Independent,1040,0,1040,21
Maharashtra,Nanded,SONTAKKE LAXMAN KISHAN,Independent,1667,0,1667,22
Maharashtra,Nanded,HANMANTE VIJAY CHANDRAO,Independent,1479,0,1479,23
Maharashtra,Nanded,None of the Above,NOTA,3151,4,3155,24
Maharashtra,Parbhani,GULMIR KHAN,Bahujan Samaj Party,33709,7,33716,1
Maharashtra,Parbhani,JADHAV SANJAY (BANDU) HARIBHAU,Shivsena,578067,388,578455,2
Maharashtra,Parbhani,BHAMBALE VIJAY MANIKRAO,Nationalist Congress Party,451108,192,451300,3
Maharashtra,Parbhani,COMRADE RAJAN KSHIRSAGAR,Communist Party of India,12403,1,12404,4
Maharashtra,Parbhani,ADV. AJAY SITARAM KARANDE PATIL,Samajwadi Party,5507,0,5507,5
Maharashtra,Parbhani,ASHOK BABARAO (AMBHORE) DUDHGAONKAR,ANC,1869,0,1869,6
Maharashtra,Parbhani,MD. ILIYAS MD. AMIR MANIYAR,Bharipa Bahujan Mahasangha,8006,0,8006,7
Maharashtra,Parbhani,BABAN (ANNA) MULEY,Bahujan Mukti Party,5829,7,5836,8
Maharashtra,Parbhani,SAYED ABDUL RAHIM,Welfare Party of India,2491,1,2492,9
Maharashtra,Parbhani,SALMA SHRINIWAS KULKARNI,Aam Aadmi Party,4442,7,4449,10
Maharashtra,Parbhani,SK. SALEEM,Majlis Bachao Tahreek,2947,0,2947,11
Maharashtra,Parbhani,UDHAV RANGRAO PAWAR (PATIL),Independent,6154,0,6154,12
Maharashtra,Parbhani,KAJALE PRADIP MAHADEV,Independent,4781,0,4781,13
Maharashtra,Parbhani,NISAR SUBHAN KHAN PATHAN,Independent,12341,0,12341,14
Maharashtra,Parbhani,PRAMOD MAROTI PANDITKAR,Independent,4103,0,4103,15
Maharashtra,Parbhani,COMRED BHISE GANPAT DEVRAO,Independent,7251,0,7251,16
Maharashtra,Parbhani,RAMRAO DHANSING RATHOD SIR NIRANKARI,Independent,3120,0,3120,17
Maharashtra,Parbhani,None of the Above,NOTA,17496,6,17502,18
Maharashtra,Jalna,AUTADE VILAS KESHAVRAO,Indian National Congress,384511,119,384630,1
Maharashtra,Jalna,DANVE RAOSAHEB DADARAO,Bharatiya Janata Party,590849,579,591428,2
Maharashtra,Jalna,DR. WANKHEDE SHARADCHANDRA GANAPATRAO,Bahujan Samaj Party,23711,8,23719,3
Maharashtra,Jalna,AGRAWAL KUNJBIHARI JUGALKISHOR,Samajwadi Party,3469,0,3469,4
Maharashtra,Jalna,RAMBHAU HARIBHAU UGLE,Rashtriya Sant Sandesh Party,3282,1,3283,5
Maharashtra,Jalna,MIRZA AFSAR BEG,Welfare Party of India,2467,0,2467,6
Maharashtra,Jalna,MOHAMMAD ASAD SHAIKH AHEMAD,MNDP,1340,2,1342,7
Maharashtra,Jalna,DILIP DATTA MHASKE,Aam Aadmi Party,4605,17,4622,8
Maharashtra,Jalna,RATHOD RAMESH LALSING,Bahujan Mukti Party,2461,1,2462,9
Maharashtra,Jalna,VITTHAL SAHEBRAO SHELKE,APoI,4586,1,4587,10
Maharashtra,Jalna,SANJAY NIVRUTTI HIVRALE,ANC,1821,0,1821,11
Maharashtra,Jalna,UNGE RAMBHAU KUNDLIK,Independent,2240,0,2240,12
Maharashtra,Jalna,KARANDE GANESH NAVNATHRAO,Independent,2874,0,2874,13
Maharashtra,Jalna,KAKARWAL PRATAPSING MAHAJAN,Independent,4234,3,4237,14
Maharashtra,Jalna,AD. MAHESH VITTHALRAO KHARAT,Independent,1967,0,1967,15
Maharashtra,Jalna,RAMBHAU VITTHAL CHINCHORE,Independent,1120,0,1120,16
Maharashtra,Jalna,NADE DNYANESHWAR DAGDUJI,Independent,6953,0,6953,17
Maharashtra,Jalna,M. JAVED A. WAHAB,Independent,7704,0,7704,18
Maharashtra,Jalna,BABASAHEB PATIL SHINDE,Independent,6547,0,6547,19
Maharashtra,Jalna,SAPKAL LILABAI DHARMA,Independent,1110,0,1110,20
Maharashtra,Jalna,SAYYAD HUSAIN AHMAD,Independent,1655,0,1655,21
Maharashtra,Jalna,ASHOK VITTHAL SONWANE,Independent,1893,1,1894,22
Maharashtra,Jalna,None of the Above,NOTA,4127,1,4128,23
Maharashtra,Aurangabad,CHANDRAKANT BHAURAO KHAIRE,Shivsena,520559,343,520902,1
Maharashtra,Aurangabad,JEVRIKAR INDRAKUMAR DNYANOBA,Bahujan Samaj Party,37412,7,37419,2
Maharashtra,Aurangabad,PATIL NITIN SURESH,Indian National Congress,358812,90,358902,3
Maharashtra,Aurangabad,ABDUL KHUDUS ABDUL SAMAD SHAIKH,Bahujan Mukti Party,3774,1,3775,4
Maharashtra,Aurangabad,JADHAV PUSHPA SHANTILAL,ANC,1037,1,1038,5
Maharashtra,Aurangabad,BANSWAL MANNALAL PREMCHAND,PRCP,893,0,893,6
Maharashtra,Aurangabad,MOHMMAD KISMATWALA KASIM KISMATWALA,GaAP,1198,3,1201,7
Maharashtra,Aurangabad,GAYAKE SADASHIV AMBADAS,Samajwadi Party,2646,0,2646,8
Maharashtra,Aurangabad,SAYYAD SHAFIYODDIN VAHIYODDIN,Welfare Party of India,2885,0,2885,9
Maharashtra,Aurangabad,SUBHASH KALYANRAO LOMTE,Aam Aadmi Party,11969,5,11974,10
Maharashtra,Aurangabad,AHAMAD AZIZ AHAMAD MATEEN,Independent,1572,0,1572,11
Maharashtra,Aurangabad,BANSODE UDHAV GOVARDHAN,Independent,1795,0,1795,12
Maharashtra,Aurangabad,ANKUSH MUNJAJI TUPSAMUNDRE,Independent,2019,0,2019,13
Maharashtra,Aurangabad,KAILAS CHANDRABHAN THENGDE,Independent,2123,0,2123,14
Maharashtra,Aurangabad,JAGDIP VISHWANATH SHINDE,Independent,1530,0,1530,15
Maharashtra,Aurangabad,TRIBHUVAN MADHUKAR PADMAKAR,Independent,6135,0,6135,16
Maharashtra,Aurangabad,DANDGE NANASAHEB DAMODHAR,Independent,5901,0,5901,17
Maharashtra,Aurangabad,NADEEM RANA,Independent,2922,0,2922,18
Maharashtra,Aurangabad,PHULARE SURESH ASARAM,Independent,2520,0,2520,19
Maharashtra,Aurangabad,DR. FEROZ KHAN MURTUZA KHAN,Independent,978,0,978,20
Maharashtra,Aurangabad,BALASAHEB ASARAM SARATE,Independent,880,0,880,21
Maharashtra,Aurangabad,BALASAHEB VITTHAL AWARE,Independent,614,0,614,22
Maharashtra,Aurangabad,JAWAHARLAL LAXMAN BHAGURE,Independent,877,1,878,23
Maharashtra,Aurangabad,BHANUDAS RAMDAS SARODE,Independent,934,0,934,24
Maharashtra,Aurangabad,RAJU BABURAO DOLE,Independent,1238,0,1238,25
Maharashtra,Aurangabad,NANDARKAR VISHAL UDDHAV,Independent,1306,0,1306,26
Maharashtra,Aurangabad,SHAIK SAYYAD SHAIK MAHMOOD,Independent,1581,0,1581,27
Maharashtra,Aurangabad,None of the Above,NOTA,6370,2,6372,28
Maharashtra,Dindori ,CHAVAN HARISHCHANDRA DEORAM,Bharatiya Janata Party,542305,479,542784,1
Maharashtra,Dindori ,DR. BHARATI PRAVIN PAWAR,Nationalist Congress Party,294995,170,295165,2
Maharashtra,Dindori ,MALI SHARAD SAHEBRAO,Bahujan Samaj Party,17723,1,17724,3
Maharashtra,Dindori ,COM. HEMANT MOTIRAM WAGHERE,Communist Party of India  (Marxist),72583,16,72599,4
Maharashtra,Dindori ,PRABHAT CHINDHU SONAWANE,Bharipa Bahujan Mahasangha,5574,4,5578,5
Maharashtra,Dindori ,BHARAT KISAN MATE,Bahujan Mukti Party,2022,2,2024,6
Maharashtra,Dindori ,PROF. DNYANESHWAR DAMU MALI,Aam Aadmi Party,4059,8,4067,7
Maharashtra,Dindori ,AJITDADA BHIKA PAWAR,Independent,5177,0,5177,8
Maharashtra,Dindori ,KAILAS SAKHARAM MORE,Independent,3900,0,3900,9
Maharashtra,Dindori ,GAIKWAD ABHIJEET KALYANRAO,Independent,10267,0,10267,10
Maharashtra,Dindori ,None of the Above,NOTA,10894,3,10897,11
Maharashtra,Nashik,GODSE HEMANT TUKARAM,Shivsena,493605,1130,494735,1
Maharashtra,Nashik,CHHAGAN BHUJBAL,Nationalist Congress Party,306726,673,307399,2
Maharashtra,Nashik,ADV. TANAJI SUKDEO JAIBHAVE,Communist Party of India  (Marxist),17136,18,17154,3
Maharashtra,Nashik,DINKAR DHARMA PATIL,Bahujan Samaj Party,20883,13,20896,4
Maharashtra,Nashik,DR. PRADEEP PAWAR,MNS,62936,114,63050,5
Maharashtra,Nashik,AVHAD MAHESH ZUNJAR,All India Forward Bloc,1204,0,1204,6
Maharashtra,Nashik,PATHAN AYUB MADDEKHAN,Indian Union Muslim League,697,0,697,7
Maharashtra,Nashik,PATHAN SAKHAWATKHA YASINKHA,Bahujan Mukti Party,842,3,845,8
Maharashtra,Nashik,VIJAY BALIRAM PANDHARE,Aam Aadmi Party,9634,38,9672,9
Maharashtra,Nashik,PRAKASH GIRDHAR KANOJE,Independent,1121,0,1121,10
Maharashtra,Nashik,PRAMOD GYANIRAM NATHEKAR,Independent,1580,0,1580,11
Maharashtra,Nashik,FASALE BABAN NAMDEO,Independent,3792,0,3792,12
Maharashtra,Nashik,MAKSUD ILIYAS KHAN,Independent,1253,0,1253,13
Maharashtra,Nashik,VISHNU RAMDAS JADHAV,Independent,1666,0,1666,14
Maharashtra,Nashik,SARKATE DEVIDAS PIRAJI,Independent,3425,0,3425,15
Maharashtra,Nashik,None of the Above,NOTA,8905,11,8916,16
Maharashtra,Palghar ,KHARAPADE LADAKYA RUPA,Communist Party of India  (Marxist),76888,2,76890,1
Maharashtra,Palghar ,GAVARI SHYAM ANANT,Bahujan Samaj Party,8176,0,8176,2
Maharashtra,Palghar ,ADV. CHINTAMAN NAVASHA WANGA,Bharatiya Janata Party,532996,205,533201,3
Maharashtra,Palghar ,DILIP ATMARAM DUMADA,Bahujan Mukti Party,10741,1,10742,4
Maharashtra,Palghar ,PANDURANG JETHYA PARDHI,Aam Aadmi Party,16173,9,16182,5
Maharashtra,Palghar ,BALIRAM SUKUR JADHAV,BVA,293569,112,293681,6
Maharashtra,Palghar ,MOHAN BARKU GUHE,Bharipa Bahujan Mahasangha,6691,0,6691,7
Maharashtra,Palghar ,KASHINATH LAXMAN KOKERA,Independent,4327,0,4327,8
Maharashtra,Palghar ,SACHIN DAMODAR SHINGDA,Independent,7956,1,7957,9
Maharashtra,Palghar ,HARIBHAU SOMA VARTHA,Independent,12973,1,12974,10
Maharashtra,Palghar ,None of the Above,NOTA,21790,7,21797,11
Maharashtra,Bhiwandi,ANSARI MUMTAZ ABDUL SATAR,Bahujan Samaj Party,14064,4,14068,1
Maharashtra,Bhiwandi,KAPIL MORESHWAR PATIL,Bharatiya Janata Party,410752,318,411070,2
Maharashtra,Bhiwandi,PATIL VISHWANATH RAMCHANDRA,Indian National Congress,301452,168,301620,3
Maharashtra,Bhiwandi,MADHUKAR VITTHAL PATIL,Communist Party of India,13718,2,13720,4
Maharashtra,Bhiwandi,SURESH (BALYA MAMA) GOPINATH MHATRE,MNS,93600,47,93647,5
Maharashtra,Bhiwandi,ADV. DR. ANITA BALASAHEB KOLEKAR,PRCP,1375,1,1376,6
Maharashtra,Bhiwandi,ANSARI JALAL ENGINEER,Aam Aadmi Party,11049,6,11055,7
Maharashtra,Bhiwandi,ANSARI JAHID MUKHTAR,Bahujan Mukti Party,2122,4,2126,8
Maharashtra,Bhiwandi,YOGESH MOTIRAM KATHORE,Bharipa Bahujan Mahasangha,3054,4,3058,9
Maharashtra,Bhiwandi,SHAH ABRAR AHMED NAZEER,Peace Party,2120,0,2120,10
Maharashtra,Bhiwandi,ENGINEER NAVID BETAB,Independent,2435,0,2435,11
Maharashtra,Bhiwandi,SURESH KALURAM JADHAV,Independent,5941,0,5941,12
Maharashtra,Bhiwandi,HARISHCHANDRA DATTU PATIL,Independent,4058,0,4058,13
Maharashtra,Bhiwandi,None of the Above,NOTA,9304,7,9311,14
Maharashtra,Kalyan,ANAND PRAKASH PARANJPE,Nationalist Congress Party,190006,137,190143,1
Maharashtra,Kalyan,KIRATKAR DAYANAND TULSHIRAM,Bahujan Samaj Party,19635,8,19643,2
Maharashtra,Kalyan,PRAMOD (RAJU) RATAN PATIL,MNS,122255,94,122349,3
Maharashtra,Kalyan,DR.SHRIKANT EKNATH SHINDE,Shivsena,440574,318,440892,4
Maharashtra,Kalyan,ANIL MORE,Bahujan Mukti Party,3530,1,3531,5
Maharashtra,Kalyan,NARESH ARVIND THAKUR,Aam Aadmi Party,20326,21,20347,6
Maharashtra,Kalyan,BELAMKAR MILIND CHANDRAKANT,LB,539,1,540,7
Maharashtra,Kalyan,BHOSALE SHAMU RAMU,Bharipa Bahujan Mahasangha,1865,4,1869,8
Maharashtra,Kalyan,SUDHAKAR NARAYAN SHINDE,APoI,725,1,726,9
Maharashtra,Kalyan,SULOCHANA DHARMENDRA SONKAMBLE,Republican Bahujan Sena,1227,2,1229,10
Maharashtra,Kalyan,MOHAMMAD HAMEED SAYYED,Samajwadi Party,3046,1,3047,11
Maharashtra,Kalyan,ASMITA PUSHKAR PURANIK,Independent,1243,0,1243,12
Maharashtra,Kalyan,MOHAMMED AHMED MUKHTAR KHAN ALIAS AHMED NETA,Independent,2467,0,2467,13
Maharashtra,Kalyan,TELGOTE PRAKASH SHAMRAO,Independent,1600,0,1600,14
Maharashtra,Kalyan,DILIP PRABHAKAR ALONI (JOSHI),Independent,1222,0,1222,15
Maharashtra,Kalyan,MOTE CHANDRAKANT RAMBHAJI,Independent,1279,0,1279,16
Maharashtra,Kalyan,SHASHIKANT DADA RASAL,Independent,2096,0,2096,17
Maharashtra,Kalyan,SHIVA KRISHNAMURTHY IYAR,Independent,788,0,788,18
Maharashtra,Kalyan,None of the Above,NOTA,9175,10,9185,19
Maharashtra,Thane,ABHIJIT RAMESH PANSE,MNS,48804,59,48863,1
Maharashtra,Thane,KIRTAWADE VIDHYADHAR BHIMRAO,Bahujan Samaj Party,10968,14,10982,2
Maharashtra,Thane,SANJEEV GANESH NAIK,Nationalist Congress Party,313860,205,314065,3
Maharashtra,Thane,VICHARE RAJAN BABURAO,Shivsena,594804,560,595364,4
Maharashtra,Thane,ASHOK SHANKAR JADHAV,Bahujan Mukti Party,4017,5,4022,5
Maharashtra,Thane,GOPINATH SAKHARAM MHASKE,Bharipa Bahujan Mahasangha,2409,3,2412,6
Maharashtra,Thane,JAIN SURENDRAKUMAR K.,Akhil Bharatiya Jan Sangh,641,0,641,7
Maharashtra,Thane,NITIN SHANKAR DESHPANDE,DaP,2173,2,2175,8
Maharashtra,Thane,QAMRUZZAMAN KUTUBALI MINAI,Peace Party,1196,0,1196,9
Maharashtra,Thane,RAJU SHRAVAN CHAVAN,Republican Bahujan Sena,1681,0,1681,10
Maharashtra,Thane,RAJENDRA GAJBHIYE,APoI,905,0,905,11
Maharashtra,Thane,RATHOD BABUSINGH VASRAM,MPS(T),636,0,636,12
Maharashtra,Thane,SALMAN AJIMULLAH HASMI,RAPa,1402,0,1402,13
Maharashtra,Thane,SANJEEV VISHNU SANE,Aam Aadmi Party,41499,36,41535,14
Maharashtra,Thane,SHRINATH MITHANTHAYA,Hindustan Janta Party,891,0,891,15
Maharashtra,Thane,ABHAY SUBRAO KULKARNI,Independent,1891,0,1891,16
Maharashtra,Thane,SHAFIK AHAMAD SADAT KHAN,Independent,1865,0,1865,17
Maharashtra,Thane,TRILOKI GHURAHU YADAV,Independent,1066,0,1066,18
Maharashtra,Thane,NAJAKATALI KABIR ANSARI,Independent,1549,0,1549,19
Maharashtra,Thane,NARENDRA PRABHASHANKAR PANDEY,Independent,2141,0,2141,20
Maharashtra,Thane,BHANUDAS DHOTARE,Independent,488,0,488,21
Maharashtra,Thane,RAMCHANDRA BHAGOJI GAWADE,Independent,493,0,493,22
Maharashtra,Thane,VINOD DEEPCHAND GANGWAL,Independent,650,0,650,23
Maharashtra,Thane,VISHAL DINKAR SALVE,Independent,705,0,705,24
Maharashtra,Thane,SANJAY DILIP KUMAR DAS,Independent,918,0,918,25
Maharashtra,Thane,SOHANLAL PUROHIT,Independent,2479,0,2479,26
Maharashtra,Thane,None of the Above,NOTA,13157,17,13174,27
Maharashtra,Mumbai North,GOPAL CHINAYYA SHETTY,Bharatiya Janata Party,663309,695,664004,1
Maharashtra,Mumbai North,SINGH ASHOK CHANDRAPAL,Bahujan Samaj Party,5429,9,5438,2
Maharashtra,Mumbai North,SANJAY BRIJKISHORLAL NIRUPAM,Indian National Congress,217286,136,217422,3
Maharashtra,Mumbai North,ARJUN BALU ARDE,APoI,1647,3,1650,4
Maharashtra,Mumbai North,GONDANE DIVAKAR LAXMAN,Bharipa Bahujan Mahasangha,1535,4,1539,5
Maharashtra,Mumbai North,THORAT SUNIL UTTAMRAO,All India Forward Bloc,653,0,653,6
Maharashtra,Mumbai North,DINESH SHAH,Sardar Vallabhbhai Patel Party,394,0,394,7
Maharashtra,Mumbai North,NITIN RAVINDRA RAJVARDHAN,Bahujan Mukti Party,796,0,796,8
Maharashtra,Mumbai North,PRABHAKARAN G. TITUS,PPIS,330,1,331,9
Maharashtra,Mumbai North,MOHAMMAD AKHTAR MEHBOOB SHAIKH,PRCP,462,0,462,10
Maharashtra,Mumbai North,YADAV KAMLESH SHOBHNATH,Samajwadi Party,5499,7,5506,11
Maharashtra,Mumbai North,SAKHARAM PANDURANG DUNGHAV,MPS(T),696,3,699,12
Maharashtra,Mumbai North,SATISH PARASMAL JAIN,Aam Aadmi Party,32325,39,32364,13
Maharashtra,Mumbai North,HAJI AKHTAR PAPERWALA,Independent,626,0,626,14
Maharashtra,Mumbai North,ARJUN CHAUDHARY,Independent,556,0,556,15
Maharashtra,Mumbai North,KAPIL KANTILAL SONI,Independent,2075,3,2078,16
Maharashtra,Mumbai North,PRASHANT NARSINH KHARATMAL,Independent,1612,0,1612,17
Maharashtra,Mumbai North,MILIND SHANKAR REPE,Independent,301,0,301,18
Maharashtra,Mumbai North,SHAIKH FATEH MOHAMMAD,Independent,767,1,768,19
Maharashtra,Mumbai North,SATYAVIJAY VITHOBA CHAVAN,Independent,326,1,327,20
Maharashtra,Mumbai North,SUBODH G. RANJAN,Independent,278,0,278,21
Maharashtra,Mumbai North,None of the Above,NOTA,8740,18,8758,22
Maharashtra,Mumbai North West,KAMAT GURUDAS VASANT,Indian National Congress,281683,109,281792,1
Maharashtra,Mumbai North West,GAJANAN CHANDRAKANT KIRTIKAR,Shivsena,464522,298,464820,2
Maharashtra,Mumbai North West,BHOLE PUSHPA MILIND,Bahujan Samaj Party,10272,3,10275,3
Maharashtra,Mumbai North West,MAHESH WAMAN MANJREKAR,MNS,66020,68,66088,4
Maharashtra,Mumbai North West,PRAVIN  CHANDRAKANT  KAURPURIYA,HSCP,887,1,888,5
Maharashtra,Mumbai North West,MAYANK RAMESH GANDHI,Aam Aadmi Party,51835,25,51860,6
Maharashtra,Mumbai North West,MOHAN  GALVANKAR,lpi,694,0,694,7
Maharashtra,Mumbai North West,MANGESH MADHUKAR HUMNE,Bahujan Mukti Party,1081,1,1082,8
Maharashtra,Mumbai North West,RAKHI SAWANT,RAPa,2004,2,2006,9
Maharashtra,Mumbai North West,VIJAYANAND  SHANKARRAO  SHINDE,HND,514,0,514,10
Maharashtra,Mumbai North West,NITIN H.  KHARE,Independent,1078,0,1078,11
Maharashtra,Mumbai North West,PRATIK  PRABHAKAR  TORASKAR,Independent,514,1,515,12
Maharashtra,Mumbai North West,RINA  MAHENDRAKUMAR  ZAVERI,Independent,1530,0,1530,13
Maharashtra,Mumbai North West,SONKAMBLE  GAJANAN  TUKARAM,Independent,1366,0,1366,14
Maharashtra,Mumbai North West,None of the Above,NOTA,10997,12,11009,15
Maharashtra,Mumbai North East,KIRIT  SOMAIYA,Bharatiya Janata Party,524895,390,525285,1
Maharashtra,Mumbai North East,MATCHINDRA  HANUMANTRAO CHATE,Bahujan Samaj Party,17422,5,17427,2
Maharashtra,Mumbai North East,SANJAY DINA PATIL,Nationalist Congress Party,208001,162,208163,3
Maharashtra,Mumbai North East,PROF. AVINASH DOLAS,Bharipa Bahujan Mahasangha,8829,4,8833,4
Maharashtra,Mumbai North East,TUKARAM BABURAO MANE,Bahujan Mukti Party,1837,1,1838,5
Maharashtra,Mumbai North East,PRAKASH SADASHIV PANCHARAS,MPS(T),1325,0,1325,6
Maharashtra,Mumbai North East,PRASHANT DNYANESHWAR GANGAWANE,PRCP,1307,1,1308,7
Maharashtra,Mumbai North East,MEDHA PATKAR,Aam Aadmi Party,76369,82,76451,8
Maharashtra,Mumbai North East,SAYED GULAMHUSAIN  AMIRHAMZA,Republican Party of India,1012,0,1012,9
Maharashtra,Mumbai North East,HAYAT ABDULLAH SHAIKH,Indian Union Muslim League,621,0,621,10
Maharashtra,Mumbai North East,ADV. AMARSEN BABURAO BABAR,Independent,468,0,468,11
Maharashtra,Mumbai North East,ANANDA   SAKHARAM  BHALERAO,Independent,369,0,369,12
Maharashtra,Mumbai North East,KHAN SHAMIM BANU,Independent,902,0,902,13
Maharashtra,Mumbai North East,TUPSOUNDARYA SUNITA MOHAN,Independent,881,0,881,14
Maharashtra,Mumbai North East,DEEPAK DIGAMBAR SHINDE,Independent,1359,0,1359,15
Maharashtra,Mumbai North East,FIROZ AHMED SIDDIQUI,Independent,2243,0,2243,16
Maharashtra,Mumbai North East,BANSODE DILIP BAPU,Independent,2784,0,2784,17
Maharashtra,Mumbai North East,SABIR MEHANDI HASAN,Independent,626,0,626,18
Maharashtra,Mumbai North East,SANJAY SAOJI DESHPANDE,Independent,2752,0,2752,19
Maharashtra,Mumbai North East,None of the Above,NOTA,7108,6,7114,20
Maharashtra,Mumbai North central,SHINDE ANAND VYANKATRAO,Bahujan Samaj Party,10124,4,10128,1
Maharashtra,Mumbai North central,DUTT PRIYA SUNIL,Indian National Congress,291655,109,291764,2
Maharashtra,Mumbai North central,POONAM MAHAJAN ALIAS POONAM VAJENDLA RAO,Bharatiya Janata Party,478264,271,478535,3
Maharashtra,Mumbai North central,AZIMUDDIN KHAN,lpi,2099,0,2099,4
Maharashtra,Mumbai North central,ABU FARHAN AZMI,Samajwadi Party,9873,0,9873,5
Maharashtra,Mumbai North central,ASHOK KISAN LOKHANDE,Republican Party of India,579,2,581,6
Maharashtra,Mumbai North central,UMESH SONBA AVHAD,MPS(T),657,0,657,7
Maharashtra,Mumbai North central,NIYAZ AHMED ALLAUDDIN SHAIKH,AwVP,512,0,512,8
Maharashtra,Mumbai North central,PHIROZE PALKHIVALA,Aam Aadmi Party,34794,30,34824,9
Maharashtra,Mumbai North central,BIRJE HEMANT ANANT,All India Forward Bloc,693,0,693,10
Maharashtra,Mumbai North central,MEHER A. MALLICK,Bahujan Mukti Party,588,0,588,11
Maharashtra,Mumbai North central,MOHAMMED RAFIK HUSSAIN SHAIKH,National Loktantrik Party,308,0,308,12
Maharashtra,Mumbai North central,UPESH M. BARIA,Independent,334,0,334,13
Maharashtra,Mumbai North central,GUPTA KANHAIYALAL RAJARAM,Independent,858,0,858,14
Maharashtra,Mumbai North central,CHAWAN SURYAKANT GANGARAM,Independent,786,1,787,15
Maharashtra,Mumbai North central,DINESH PHULSING RATHOD,Independent,1261,0,1261,16
Maharashtra,Mumbai North central,FRANCIS LAWRENCE FERNANDES,Independent,652,1,653,17
Maharashtra,Mumbai North central,MINAKSHI MUKUND JADHAV,Independent,1022,0,1022,18
Maharashtra,Mumbai North central,SHITAL KUMAR JAIN,Independent,1380,0,1380,19
Maharashtra,Mumbai North central,SURESH GIGA DABHI,Independent,872,0,872,20
Maharashtra,Mumbai North central,SANJU VERMA,Independent,625,1,626,21
Maharashtra,Mumbai North central,None of the Above,NOTA,6931,6,6937,22
Maharashtra,Mumbai South central,ADV.AIYYAR GANESH,Bahujan Samaj Party,14754,8,14762,1
Maharashtra,Mumbai South central,ADITYA RAJAN SHIRODKAR,MNS,73026,70,73096,2
Maharashtra,Mumbai South central,EKNATH M. GAIKWAD,Indian National Congress,242701,127,242828,3
Maharashtra,Mumbai South central,RAHUL RAMESH SHEWALE,Shivsena,380747,261,381008,4
Maharashtra,Mumbai South central,ABBAS HUSSAIN SHAIKH,Samajwadi Party,5572,1,5573,5
Maharashtra,Mumbai South central,ASLAM HANIF KHOT,Peace Party,1016,0,1016,6
Maharashtra,Mumbai South central,SANGHAPAL HIRACHAND GADEKAR,APoI,919,0,919,7
Maharashtra,Mumbai South central,SUNDAR BALAKRISHNAN,Aam Aadmi Party,27672,15,27687,8
Maharashtra,Mumbai South central,HUSSAIN AKBAR SAYYED,Bahujan Mukti Party,1428,2,1430,9
Maharashtra,Mumbai South central,CLIFFORD MARTIS,Independent,799,0,799,10
Maharashtra,Mumbai South central,KHAN SIRAJ AHMED,Independent,545,0,545,11
Maharashtra,Mumbai South central,GANESH BHIMRAO BUDHE,Independent,514,0,514,12
Maharashtra,Mumbai South central,DILIP GAIKWAD,Independent,1338,0,1338,13
Maharashtra,Mumbai South central,MR. NADAR SELVAKUMAR PERIMBRAJ,Independent,684,2,686,14
Maharashtra,Mumbai South central,NAMDEV SAHEBRAO SABLE,Independent,1183,0,1183,15
Maharashtra,Mumbai South central,NOOR MOHAMMAD SAHEB RAJA KHAN,Independent,1588,0,1588,16
Maharashtra,Mumbai South central,PAL JITENDRA KUMAR,Independent,453,0,453,17
Maharashtra,Mumbai South central,MAHENDRA TULSHIRAM BHINGARDIVE,Independent,918,0,918,18
Maharashtra,Mumbai South central,MOIN SOHAIL SAYYED,Independent,1212,0,1212,19
Maharashtra,Mumbai South central,ADV.VAISHALI SURENDRA BORDE,Independent,1083,0,1083,20
Maharashtra,Mumbai South central,SHINDE SARJERAO MAHADEV,Independent,418,0,418,21
Maharashtra,Mumbai South central,None of the Above,NOTA,9560,11,9571,22
Maharashtra,Mumbai   South,ABDUS SALAM KHAN  QASMI,Bahujan Samaj Party,6658,6,6664,1
Maharashtra,Mumbai   South,ARVIND SAWANT,Shivsena,374079,530,374609,2
Maharashtra,Mumbai   South,DEORA MILIND MURLI,Indian National Congress,245850,195,246045,3
Maharashtra,Mumbai   South,PRAKASH REDDY,Communist Party of India,6897,0,6897,4
Maharashtra,Mumbai   South,BALA NANDGAONKAR,MNS,84497,276,84773,5
Maharashtra,Mumbai   South,BAIG MIRZA KALIM,lpi,677,0,677,6
Maharashtra,Mumbai   South,MEERA SANYAL,Aam Aadmi Party,40268,30,40298,7
Maharashtra,Mumbai   South,SHAHZAD SHAMSHER KHAN PATHAN,AwVP,914,3,917,8
Maharashtra,Mumbai   South,SHEHBAJ RATHOD,Jai Maha Bharath Party,414,0,414,9
Maharashtra,Mumbai   South,SACHIN PAWAR,Bahujan Mukti Party,1262,4,1266,10
Maharashtra,Mumbai   South,ABDUL LATIF ABDUL KADAR SHAIKH,Independent,400,0,400,11
Maharashtra,Mumbai   South,DR. OMRAJ L. RATHOD,Independent,674,0,674,12
Maharashtra,Mumbai   South,KATARIA JITENDRA KAMABHAI,Independent,595,0,595,13
Maharashtra,Mumbai   South,GAURAV SHARMA,Independent,558,1,559,14
Maharashtra,Mumbai   South,JAHEDA MOHAMMED HANIF SHAIKH,Independent,701,0,701,15
Maharashtra,Mumbai   South,FARNANDES SANTAN,Independent,1077,0,1077,16
Maharashtra,Mumbai   South,BASIT FAITH,Independent,763,1,764,17
Maharashtra,Mumbai   South,RATAN DEVRAM BODKE,Independent,1324,0,1324,18
Maharashtra,Mumbai   South,RAJENDRA DAULAT DESAI,Independent,1059,0,1059,19
Maharashtra,Mumbai   South,SHANKAR  SONAWANE,Independent,454,1,455,20
Maharashtra,Mumbai   South,None of the Above,NOTA,9545,28,9573,21
Maharashtra,Raigad,ANANT GEETE,Shivsena,395951,227,396178,1
Maharashtra,Raigad,TATKARE SUNIL DATTATREY,Nationalist Congress Party,394007,61,394068,2
Maharashtra,Raigad,YASHWANT JAYRAM GAIKWAD,Bahujan Samaj Party,10507,3,10510,3
Maharashtra,Raigad,DR. APARANTI SANJAY YASHWANT,Aam Aadmi Party,6749,10,6759,4
Maharashtra,Raigad,AZIZ ABDUL KADIR MUKADAM,Samajwadi Party,2763,0,2763,5
Maharashtra,Raigad,DR. GHONE ADESH YASHAWANT,Bahujan Mukti Party,3308,0,3308,6
Maharashtra,Raigad,RAMESHBHAI KADAM,Peasants And Workers Party of India,129709,21,129730,7
Maharashtra,Raigad,SANDEEP PANDURANG PARTE,Hindustan Janta Party,4286,1,4287,8
Maharashtra,Raigad,MUZZAFAR JAINUDDIN CHAUDHARI  ALIAS MODI,Independent,9952,0,9952,9
Maharashtra,Raigad,SUNIL TATKARE,Independent,9847,2,9849,10
Maharashtra,Raigad,None of the Above,NOTA,20358,4,20362,11
Maharashtra,Maval,BHIMAPUTRA TEXAS GAIKWAD,Bahujan Samaj Party,25974,8,25982,1
Maharashtra,Maval,NARWEKAR RAHUL SURESH,Nationalist Congress Party,182237,56,182293,2
Maharashtra,Maval,APPA ALIAS SHRIRANG CHANDU BARNE,Shivsena,512030,196,512226,3
Maharashtra,Maval,GHARAT SANTOSH ROHIDAS,Bahujan Mukti Party,8939,1,8940,4
Maharashtra,Maval,JAGTAP LAXMANBHAU PANDURANG,Peasants And Workers Party of India,354730,99,354829,5
Maharashtra,Maval,BARNE SHRIRANG CHIMAJI,Janata Dal (United),11256,3,11259,6
Maharashtra,Maval,BHAPKAR MARUTI SAHEBRAO,Aam Aadmi Party,30555,11,30566,7
Maharashtra,Maval,SIMA DHARMANNA MANIKADI,PRCP,1765,0,1765,8
Maharashtra,Maval,ABHIJIT ANIL APTE,Independent,1085,0,1085,9
Maharashtra,Maval,JAGTAP LAXMAN MURLIDHAR,Independent,1599,1,1600,10
Maharashtra,Maval,JAGTAP LAXMAN SITARAM,Independent,8762,3,8765,11
Maharashtra,Maval,NANAWARE PRAMOD MAHADEO,Independent,4276,0,4276,12
Maharashtra,Maval,NURJAHAN YASIN SHAIKH,Independent,2024,0,2024,13
Maharashtra,Maval,H.B.P.ADV.R.K.PATIL,Independent,2336,0,2336,14
Maharashtra,Maval,BHIMRAO ANNA KADALE,Independent,2911,0,2911,15
Maharashtra,Maval,SIR MANUEL SABINO D''''SOUZA,Independent,4311,0,4311,16
Maharashtra,Maval,RAJENDRA MARUTI KATE,Independent,2016,0,2016,17
Maharashtra,Maval,ADV.VAISHALI SURENDRA BORDE,Independent,2536,0,2536,18
Maharashtra,Maval,SUBHASH GOPALRAO BODHE,Independent,3429,0,3429,19
Maharashtra,Maval,None of the Above,NOTA,11178,8,11186,20
Maharashtra,Pune,ANIL SHIROLE,Bharatiya Janata Party,569535,290,569825,1
Maharashtra,Pune,IMTIYAZ PEERZADE,Bahujan Samaj Party,14726,1,14727,2
Maharashtra,Pune,DEEPAK NATHARAM PAIGUDE,MNS,93449,53,93502,3
Maharashtra,Pune,DR.VISHWAJEET PATANGRAO KADAM,Indian National Congress,253949,107,254056,4
Maharashtra,Pune,ARUN BHATIA,PG,7219,3,7222,5
Maharashtra,Pune,NANA KSHIRSAGAR,Bharipa Bahujan Mahasangha,1795,2,1797,6
Maharashtra,Pune,WARE SUBHASH SHANKARRAO,Aam Aadmi Party,28640,17,28657,7
Maharashtra,Pune,SAIYYAD AFSER  IBRAHIM,Samajwadi Party,1131,0,1131,8
Maharashtra,Pune,COL SURESH PATIL (RTD),Bahujan Mukti Party,1324,0,1324,9
Maharashtra,Pune,SANJAY LAXMAN PADWAL,bns,476,1,477,10
Maharashtra,Pune,AZAM VAKIL MANIYAR,Independent,353,0,353,11
Maharashtra,Pune,AJAY VASANT PAITHANKAR,Independent,343,0,343,12
Maharashtra,Pune,ASHAPAK SHAIKH,Independent,586,0,586,13
Maharashtra,Pune,UMESH BHUJANG MASANKHAMB,Independent,494,0,494,14
Maharashtra,Pune,KHIRID SIMKUMAR BHAGWAN,Independent,380,0,380,15
Maharashtra,Pune,COLONEL JAYANTRAO CHITALE,Independent,1886,0,1886,16
Maharashtra,Pune,DAMBALE RAHUL DHARMA,Independent,2259,0,2259,17
Maharashtra,Pune,DINESH PANDURANG PAWAR,Independent,693,0,693,18
Maharashtra,Pune,DEVKULE BIBHISHAN JAGANNATH,Independent,1230,0,1230,19
Maharashtra,Pune,NILESH DHANAVE,Independent,840,0,840,20
Maharashtra,Pune,BANSODE CHAYYA TUKARAM,Independent,512,0,512,21
Maharashtra,Pune,MANCHAK TRIMBAKRAO KARALE,Independent,1028,0,1028,22
Maharashtra,Pune,YADAV GANGADHAR NATHU,Independent,454,1,455,23
Maharashtra,Pune,RUPALI TAMBOLI,Independent,377,1,378,24
Maharashtra,Pune,VIJAY LAXMAN SARODE,Independent,303,0,303,25
Maharashtra,Pune,SHASHIKANT BHIKAJI OWHAL,Independent,359,0,359,26
Maharashtra,Pune,SHIVAJI  PANDURANG ADHAV,Independent,868,0,868,27
Maharashtra,Pune,SUSHAMA PANDURANG GAIKWAD,Independent,590,0,590,28
Maharashtra,Pune,SANTOSH PAWAR,Independent,564,1,565,29
Maharashtra,Pune,None of the Above,NOTA,6436,2,6438,30
Maharashtra,Baramati,CHAUDHARI KALURAM VINAYAK,Bahujan Samaj Party,24884,24,24908,1
Maharashtra,Baramati,SUPRIYA SULE,Nationalist Congress Party,521050,512,521562,2
Maharashtra,Baramati,TATYASAHEB SITARAM TELE,Janata Dal (Secular),8804,7,8811,3
Maharashtra,Baramati,MAHADEV JAGANNATH JANKAR,RSPS,451155,688,451843,4
Maharashtra,Baramati,RAVINDRA TAKALE,Bahujan Mukti Party,7841,4,7845,5
Maharashtra,Baramati,SURESH KHOPADE,Aam Aadmi Party,26330,66,26396,6
Maharashtra,Baramati,KOKARE SHIVAJI JAYSING,Independent,4734,5,4739,7
Maharashtra,Baramati,MAHADIK PRALHAD DAGADU,Independent,2891,0,2891,8
Maharashtra,Baramati,SURESHDADA BABURAO VEER,Independent,3344,1,3345,9
Maharashtra,Baramati,None of the Above,NOTA,14195,21,14216,10
Maharashtra,Shirur,ADHALRAO SHIVAJI DATTATREY,Shivsena,642828,587,643415,1
Maharashtra,Shirur,ASHOK SHIRPATI KHANDEBHARAD,MNS,36431,17,36448,2
Maharashtra,Shirur,NIKAM DEVDATTA JAYWANT,Nationalist Congress Party,341375,226,341601,3
Maharashtra,Shirur,WAGHMARE SARJERAO BHIKA,Bahujan Samaj Party,19779,4,19783,4
Maharashtra,Shirur,GEETARAM RAMCHANDRA KADAM,Socialist Party (India),1904,2,1906,5
Maharashtra,Shirur,NIKAM SOPANRAO PANDHARINATH,Aam Aadmi Party,16657,6,16663,6
Maharashtra,Shirur,BAJARE SITARAM NAMDEO (BABA),Bahujan Mukti Party,1926,7,1933,7
Maharashtra,Shirur,VIKAS SUDAM KUSEKAR,All India Forward Bloc,1174,0,1174,8
Maharashtra,Shirur,UMESH ARJUN KANCHAN,Independent,1137,0,1137,9
Maharashtra,Shirur,KATORE MAHADEV NIWRITTI,Independent,1792,0,1792,10
Maharashtra,Shirur,DAMBALE RAM  DHARMA,Independent,2433,0,2433,11
Maharashtra,Shirur,NILESH YASHWANT MHASKULE,Independent,2118,0,2118,12
Maharashtra,Shirur,MILINDRAJE DIGAMBAR BHOSALE,Independent,3258,0,3258,13
Maharashtra,Shirur,SONALI CHANDRASHEKHAR THORAT,Independent,3850,0,3850,14
Maharashtra,Shirur,None of the Above,NOTA,11988,7,11995,15
Maharashtra,Ahmadnagar ,KAKADE KISAN YASHWANT,Bahujan Samaj Party,8381,5,8386,1
Maharashtra,Ahmadnagar ,GANDHI DILIPKUMAR MANSUKHLAL,Bharatiya Janata Party,603976,1209,605185,2
Maharashtra,Ahmadnagar ,RAJEEV APPASAHEB RAJALE,Nationalist Congress Party,395569,494,396063,3
Maharashtra,Ahmadnagar ,H.B.P. AJAY SAHEBRAO BARASKAR MAHARAJ,Bahujan Mukti Party,6000,3,6003,4
Maharashtra,Ahmadnagar ,DAMALE SHIVAJIRAO WAMAN,bns,1384,1,1385,5
Maharashtra,Ahmadnagar ,DEEPALI SAYYED,Aam Aadmi Party,7098,22,7120,6
Maharashtra,Ahmadnagar ,POPAT MANIK FULE,MPS(T),1059,2,1061,7
Maharashtra,Ahmadnagar ,ANIL JAYSING GHANVAT,Independent,3086,0,3086,8
Maharashtra,Ahmadnagar ,KOLSEPATIL BABAN GANGADHAR,Independent,12659,24,12683,9
Maharashtra,Ahmadnagar ,DESHMUKH VIKAS NANASAHEB,Independent,2202,0,2202,10
Maharashtra,Ahmadnagar ,PETRAS KISAN GAWARE,Independent,2524,1,2525,11
Maharashtra,Ahmadnagar ,LAXMAN BHANUDAS SONALE,Independent,3497,0,3497,12
Maharashtra,Ahmadnagar ,SHRIDHAR JAKHUJI DAREKAR,Independent,5648,1,5649,13
Maharashtra,Ahmadnagar ,None of the Above,NOTA,7468,5,7473,14
Maharashtra,Shirdi,BHAUSAHEB RAJARAM WAKCHAURE,Indian National Congress,332712,302,333014,1
Maharashtra,Shirdi,ADV. MAHENDRA DADASAHEB SHINDE,Bahujan Samaj Party,10377,4,10381,2
Maharashtra,Shirdi,LOKHANDE SADASHIV KISAN,Shivsena,532577,359,532936,3
Maharashtra,Shirdi,NITIN NAVNATH UDMALE,Aam Aadmi Party,11567,13,11580,4
Maharashtra,Shirdi,PAWAR VIJAY BANDERAO,lpi,2334,0,2334,5
Maharashtra,Shirdi,RAGHUNATH RAMJI MAKASARE,Bharipa Bahujan Mahasangha,3192,1,3193,6
Maharashtra,Shirdi,SARODE POPAT RAMBHAU,LB,1429,0,1429,7
Maharashtra,Shirdi,SANTOSH MADHUKAR ROHAM,Bahujan Mukti Party,9292,4,9296,8
Maharashtra,Shirdi,UDDHAVRAO BALWANT GAIKWAD,Independent,1498,1,1499,9
Maharashtra,Shirdi,GHOLAP SANDEEP BHASKAR,Independent,2229,0,2229,10
Maharashtra,Shirdi,BALASAHEB DASHRATH BAGUL,Independent,4318,1,4319,11
Maharashtra,Shirdi,WAGH GANGADHAR RADHAJI,Independent,2874,0,2874,12
Maharashtra,Shirdi,SHENDE RAVINDRA VITTHAL,Independent,4728,0,4728,13
Maharashtra,Shirdi,SAYAJI SHANKAR KHARAT,Independent,2954,0,2954,14
Maharashtra,Shirdi,None of the Above,NOTA,9873,6,9879,15
Maharashtra,Beed,DHAS SURESH RAMCHANDRA,Nationalist Congress Party,499387,154,499541,1
Maharashtra,Beed,MUNDE GOPINATHRAO PANDURANG,Bharatiya Janata Party,635426,569,635995,2
Maharashtra,Beed,RATHOD DIGAMBAR RAMRAO,Bahujan Samaj Party,14162,4,14166,3
Maharashtra,Beed,KALE KRISHNA BHANUDAS,Bharipa Bahujan Mahasangha,3162,1,3163,4
Maharashtra,Beed,DONGARE MILIND KASHINATH,PRCP,1930,0,1930,5
Maharashtra,Beed,TATE ASHOK SANTRAM,ARP,1162,0,1162,6
Maharashtra,Beed,THORAT DHANRAJ VITTHAL,MPS(T),1065,0,1065,7
Maharashtra,Beed,NANDU MADHAV,Aam Aadmi Party,4271,10,4281,8
Maharashtra,Beed,MANIKRAO MADHAVRAO BAVNE,Samajwadi Party,1584,0,1584,9
Maharashtra,Beed,RAHUL PRABHAKAR KAMBLE,APoI,1733,0,1733,10
Maharashtra,Beed,SHINGARE GOVIND BHARAT,Shivrajya Party,944,0,944,11
Maharashtra,Beed,SHAIKH IPTEKHAR ZAKEEBABA,Welfare Party of India,1628,0,1628,12
Maharashtra,Beed,SAKSAMUDRE BHAGWAN KACHRUBA,Bahujan Mukti Party,1532,1,1533,13
Maharashtra,Beed,ARJUN HANMANTA NIMBALKAR,Independent,3758,0,3758,14
Maharashtra,Beed,AVINASH NAMDEV WANKHEDE,Independent,2797,0,2797,15
Maharashtra,Beed,ASHOK DHONDIBA SONWANE,Independent,5383,0,5383,16
Maharashtra,Beed,ASHOK BHAGOJI THORAT,Independent,3264,0,3264,17
Maharashtra,Beed,AGHAV JAYPRAKASH SITARAM,Independent,3247,0,3247,18
Maharashtra,Beed,INAMDAR JABBERMIYA DAGERASA,Independent,3040,0,3040,19
Maharashtra,Beed,DR. OWHAL JITENDRA MAHADEV,Independent,1075,0,1075,20
Maharashtra,Beed,KALE BAJIRAO SHANKAR,Independent,1018,0,1018,21
Maharashtra,Beed,GANGADHAR SITARAM KALKUTE,Independent,848,0,848,22
Maharashtra,Beed,JETHLIA SANTOSHBAPU  MITTHULAL,Independent,1270,0,1270,23
Maharashtra,Beed,TEJAS ANKUSH GHUMARE,Independent,5357,0,5357,24
Maharashtra,Beed,PRASHANT VISHNU SASANE,Independent,1036,0,1036,25
Maharashtra,Beed,BHAGWAT HARIHAR TAWARE,Independent,2698,0,2698,26
Maharashtra,Beed,VEER SHESHERAO CHOKHOBA,Independent,713,0,713,27
Maharashtra,Beed,SHAIKH CHAND SHIAKH MIYA,Independent,1734,0,1734,28
Maharashtra,Beed,SHAIKH SHAFIQ SHABBIR,Independent,846,0,846,29
Maharashtra,Beed,SHRIKANT VISHNU GADALE,Independent,931,0,931,30
Maharashtra,Beed,SADULLA ASDULLA INAMDAR,Independent,2482,0,2482,31
Maharashtra,Beed,SAYYED NAVIDUJJAMMA,Independent,3732,0,3732,32
Maharashtra,Beed,SAYYED MINHAJ ALI SAYYAD WAJED ALI (PENDKHAJURWALE),Independent,3617,0,3617,33
Maharashtra,Beed,SAYYED MUBIN RAHIMTULLA,Independent,1122,0,1122,34
Maharashtra,Beed,SAYYED SALIM FATTU,Independent,452,0,452,35
Maharashtra,Beed,SUMITRABAI DASHRATH PAWAR,Independent,314,0,314,36
Maharashtra,Beed,SOLANKE PARMESHWAR KALYANRAO,Independent,520,0,520,37
Maharashtra,Beed,SOLANKE PRAKASH BHAGWANRAO,Independent,8634,0,8634,38
Maharashtra,Beed,HOKE (PATIL)RAJEDRA ACHYUTRAO,Independent,1264,0,1264,39
Maharashtra,Beed,None of the Above,NOTA,2322,1,2323,40
Maharashtra,Osmanabad,GAIKWAD RAVINDRA VISHWANATH,Shivsena,606351,1348,607699,1
Maharashtra,Osmanabad,DHALE PADMASHEEL RAMCHANDRA,Bahujan Samaj Party,28306,16,28322,2
Maharashtra,Osmanabad,PATIL PADMASINHA BAJIRAO,Nationalist Congress Party,372586,788,373374,3
Maharashtra,Osmanabad,TARKASE PUSHPA MURLIDHAR,HND,4126,0,4126,4
Maharashtra,Osmanabad,BHOSALE REVAN VISHWANATH,Janata Dal (Secular),1288,0,1288,5
Maharashtra,Osmanabad,ROKDE MILIND SOMNATH,Bharipa Bahujan Mahasangha,3722,3,3725,6
Maharashtra,Osmanabad,DR. RAMESH SUBRAV BANSODE,Republican Party of India,1700,1,1701,7
Maharashtra,Osmanabad,SHINDE RAJENDRA BHAIRAVNATH,MPS(T),1313,0,1313,8
Maharashtra,Osmanabad,VIKRAM ASHOK SAWALE,Aam Aadmi Party,4220,20,4240,9
Maharashtra,Osmanabad,ADV. SHAILENDRA RAMESHWAR YAVALKAR,Samajwadi Party,2257,0,2257,10
Maharashtra,Osmanabad,SAYYAD MOHAMD SAYYAD IBRAHIM,Bahujan Mukti Party,1527,1,1528,11
Maharashtra,Osmanabad,ALTAF HUSAIN YENEGURE,Independent,1640,0,1640,12
Maharashtra,Osmanabad,SMT. JADHAV UJVALA EKNATH,Independent,3466,0,3466,13
Maharashtra,Osmanabad,KAKASAHEB BABURAO RATHOD,Independent,7245,0,7245,14
Maharashtra,Osmanabad,GAIKWAD UMAJI PANDURANG,Independent,2352,3,2355,15
Maharashtra,Osmanabad,GAIKWAD RAVINDRA VISHWANATH,Independent,7166,3,7169,16
Maharashtra,Osmanabad,TUKARAM DASRAO GANGAWANE,Independent,10210,0,10210,17
Maharashtra,Osmanabad,TUPSUNDARE BALAJI BAPURAO,Independent,7038,0,7038,18
Maharashtra,Osmanabad,NAVNATH DASHRATH UPLEKAR,Independent,4092,0,4092,19
Maharashtra,Osmanabad,PADMSINH VIJAYSINH MUNDHE,Independent,3361,0,3361,20
Maharashtra,Osmanabad,SIDDIK IBRAHIM BOUDIWALI,Independent,1429,0,1429,21
Maharashtra,Osmanabad,PATIL MANOHAR ANANDRAO,Independent,2251,0,2251,22
Maharashtra,Osmanabad,SHAIKH MUBARAK ALIAS NANA MAINODDIN,Independent,1416,2,1418,23
Maharashtra,Osmanabad,ROHAN SUBHASH DESHMUKH,Independent,26857,11,26868,24
Maharashtra,Osmanabad,KSHIRSAGAR VIJAY MARUTI,Independent,1482,0,1482,25
Maharashtra,Osmanabad,KSHIRSAGAR SHIVAJI JAGANNATH,Independent,1978,0,1978,26
Maharashtra,Osmanabad,SUSHILKUMAR VINAYAK PADULE,Independent,1963,0,1963,27
Maharashtra,Osmanabad,None of the Above,NOTA,4611,2,4613,28
Maharashtra,Latur ,KAMBLE DEEPAK ARVIND,Bahujan Samaj Party,20001,28,20029,1
Maharashtra,Latur ,BANSODE DATTATRAY GUNDERAO,Indian National Congress,362524,590,363114,2
Maharashtra,Latur ,DR. SUNIL BALIRAM GAIKWAD,Bharatiya Janata Party,614557,1952,616509,3
Maharashtra,Latur ,DIPRATNA PRABHAKARRAO NILANGEKAR,Aam Aadmi Party,9812,17,9829,4
Maharashtra,Latur ,BALAJI DNYANOBA KAMBLE,Samajwadi Party,1840,0,1840,5
Maharashtra,Latur ,BHARAT MAROTI KADAM,APoI,2722,2,2724,6
Maharashtra,Latur ,SHIVKHANDESHWAR NARAYAN DAHGE,Bharatiya Jan-Shakti Party,1337,0,1337,7
Maharashtra,Latur ,SURYAWANSI SIDHARTH TUKARAM,Bahujan Mukti Party,2815,15,2830,8
Maharashtra,Latur ,UDARE MINAKSHI MAHADEV,Independent,1541,0,1541,9
Maharashtra,Latur ,KAMBLE MILIND HARIBHAU,Independent,942,0,942,10
Maharashtra,Latur ,GAJENDRA LIMBAJI AVGHADE,Independent,1287,0,1287,11
Maharashtra,Latur ,JARIPATKE DNYANOBA SOPANRAO,Independent,2048,4,2052,12
Maharashtra,Latur ,JOGDAND FAKIRA VAIJNATH,Independent,1305,1,1306,13
Maharashtra,Latur ,PADMAKAR KONDIBA OVHAL,Independent,1941,0,1941,14
Maharashtra,Latur ,BHARAT DAMODAR LONDHE,Independent,2035,0,2035,15
Maharashtra,Latur ,GAJANAN PANDURANG MANE,Independent,3401,0,3401,16
Maharashtra,Latur ,RAJKUMAR BHIMRAO CHANDANSHIVE,Independent,1765,0,1765,17
Maharashtra,Latur ,SHINDE SUDHIR SHRIPATRAO,Independent,8678,0,8678,18
Maharashtra,Latur ,None of the Above,NOTA,13982,14,13996,19
Maharashtra,Solapur ,SHARAD BANSODE,Bharatiya Janata Party,517176,703,517879,1
Maharashtra,Solapur ,SHINDE SUSHILKUMAR SAMBHAJIRAO,Indian National Congress,367795,410,368205,2
Maharashtra,Solapur ,ADV. SANJEEV SIDRAM SADAFULE,Bahujan Samaj Party,19030,11,19041,3
Maharashtra,Solapur ,LALIT BABAR,Aam Aadmi Party,9249,12,9261,4
Maharashtra,Solapur ,WAGHMARE PUNDALIK ONKARI,Bahujan Mukti Party,1398,1,1399,5
Maharashtra,Solapur ,SONKAMBLE GAUTAM VIJAYKUMAR,Bharipa Bahujan Mahasangha,2458,0,2458,6
Maharashtra,Solapur ,KEWALE CHAYA NAGNATH,Independent,1653,1,1654,7
Maharashtra,Solapur ,DATTATRAYA VITTHAL THORAT,Independent,824,0,824,8
Maharashtra,Solapur ,PAWAR YUVRAJ SIDRAM,Independent,1240,3,1243,9
Maharashtra,Solapur ,BHISE KRISHNA NAGNATH,Independent,1504,0,1504,10
Maharashtra,Solapur ,RAJENDRA DNYANDEO RANDIVE,Independent,1460,0,1460,11
Maharashtra,Solapur ,VIKRAM UTTAM KASABE,Independent,1333,0,1333,12
Maharashtra,Solapur ,SHINDE RAJKUMAR LAXMANRAO,Independent,1286,0,1286,13
Maharashtra,Solapur ,SIDRAM KRISHNA DHOBALE,Independent,1683,0,1683,14
Maharashtra,Solapur ,SUNITA VIJAYKUMAR UGHADE,Independent,2706,0,2706,15
Maharashtra,Solapur ,SONAWANE SHIVAJI CHANDRAKANT,Independent,5487,0,5487,16
Maharashtra,Solapur ,None of the Above,NOTA,13769,9,13778,17
Maharashtra,Madha,BANSODE KUNDAN FULCHAND,Bahujan Samaj Party,15774,16,15790,1
Maharashtra,Madha,MOHITE PATIL VIJAYSINH SHANKARRAO,Nationalist Congress Party,489260,729,489989,2
Maharashtra,Madha,NAVANATH BHIMRAO PATIL,HiPPa,8839,14,8853,3
Maharashtra,Madha,SADABHAU RAMCHANDRA KHOT,Swabhimani Paksha,464019,626,464645,4
Maharashtra,Madha,ADV. SAVITA BALKRISHNA SHINDE,Aam Aadmi Party,7128,32,7160,5
Maharashtra,Madha,ADV.SUBHASH BALASAHEB PATIL (ANNA),Bahujan Mukti Party,3285,8,3293,6
Maharashtra,Madha,SURESH SHAMRAO GHADGE,All India Trinamool Congress,1988,1,1989,7
Maharashtra,Madha,JAGTAP NITIN MARUTI,Independent,2189,0,2189,8
Maharashtra,Madha,JADHAV SUNIL GUNDA,Independent,7115,0,7115,9
Maharashtra,Madha,DAGADU MANIK PAWAR,Independent,2117,0,2117,10
Maharashtra,Madha,DEVKATE SOMANATH ALIAS SOMESHWAR CHANDRAKANT,Independent,2275,0,2275,11
Maharashtra,Madha,NAGAMANI KISAN JAKKAN,Independent,8829,0,8829,12
Maharashtra,Madha,POL SUDHIR ARJUN,Independent,2814,0,2814,13
Maharashtra,Madha,PRAFULL SHIVRAO KADAM,Independent,2300,1,2301,14
Maharashtra,Madha,DR.PRAMOD RAMCHANDRA GAWADE,Independent,1926,0,1926,15
Maharashtra,Madha,SATHI BASHIR AHMED BASHAMIYAN SHAIKH,Independent,3367,0,3367,16
Maharashtra,Madha,BALIRAM SUKHDEV MORE,Independent,4139,0,4139,17
Maharashtra,Madha,BHAJANLAL YASHVANT NIMGAONKAR,Independent,4625,0,4625,18
Maharashtra,Madha,DR.BHISE INDRAKUMAR DEVRAO,Independent,3092,2,3094,19
Maharashtra,Madha,MOHITE-PATIL PRATAPSINH SHANKARRAO,Independent,25181,6,25187,20
Maharashtra,Madha,ROHIT RAMKRUSHNA MORE,Independent,6886,0,6886,21
Maharashtra,Madha,WALKE VIKRAM VASUDEO,Independent,1969,0,1969,22
Maharashtra,Madha,SHAIKH SHAHAJAN PAIGAMBAR,Independent,2336,0,2336,23
Maharashtra,Madha,SUNITA MOHAN TUPSOUNDRYA,Independent,2519,3,2522,24
Maharashtra,Madha,None of the Above,NOTA,4201,8,4209,25
Maharashtra,Sangli,PATIL PRATIK PRAKASHBAPU,Indian National Congress,370778,1493,372271,1
Maharashtra,Sangli,BANDGAR NANASO BALASO,Bahujan Samaj Party,11363,15,11378,2
Maharashtra,Sangli,SANJAYKAKA PATIL,Bharatiya Janata Party,609402,2161,611563,3
Maharashtra,Sangli,NITIN GANPATRAO SAVGAVE,Bahujan Mukti Party,8387,18,8405,4
Maharashtra,Sangli,ADV. K. D. SHINDE,Janata Dal (Secular),2453,7,2460,5
Maharashtra,Sangli,SAMINA ABDULMAJID KHAN,Aam Aadmi Party,4645,54,4699,6
Maharashtra,Sangli,SUREKHA ALIAS SURAIYYA SHAHIN SHAIKH,MVA,847,2,849,7
Maharashtra,Sangli,ASHOK DNYANU MANE(BHAU),Independent,1489,5,1494,8
Maharashtra,Sangli,CHOPADE SHRIPRASAD JANARDAN,Independent,4309,0,4309,9
Maharashtra,Sangli,TANAJIRAO JAGANNATH  JADHAV(CHINCHANIKAR),Independent,1773,1,1774,10
Maharashtra,Sangli,DHATTURE HAFIZBHAI HUSAIN,Independent,994,3,997,11
Maharashtra,Sangli,POURNIMA VILAS KORPALE,Independent,1701,1,1702,12
Maharashtra,Sangli,MADHUKAR BABURAO KAMBALE,Independent,1844,0,1844,13
Maharashtra,Sangli,SHARMILA BABA WAKSHE,Independent,2481,0,2481,14
Maharashtra,Sangli,SHRIRANG BABURAO PAKHARE,Independent,1661,0,1661,15
Maharashtra,Sangli,SIDDHA SHIVAPPA BHOSALE,Independent,4309,0,4309,16
Maharashtra,Sangli,SURESH PARTH MANE (NANA),Independent,8351,2,8353,17
Maharashtra,Sangli,None of the Above,NOTA,6082,28,6110,18
Maharashtra,Satara,SHRIMANT CHH.  UDAYANRAJE PRATAPSINHA BHONSALE,Nationalist Congress Party,522153,378,522531,1
Maharashtra,Satara,PRASHANT VASANT CHAVAN,Bahujan Samaj Party,14491,32,14523,2
Maharashtra,Satara,ALTAF ABDULGANI SHIKALGAR,Bahujan Mukti Party,13740,20,13760,3
Maharashtra,Satara,ASHOK WAMAN GAIKWAD,Republican Party of India (A),71630,178,71808,4
Maharashtra,Satara,CHANDRAKANT TATU KHANDAIT,Bharipa Bahujan Mahasangha,12265,5,12270,5
Maharashtra,Satara,RAJENDRA MADHUKAR CHORAGE,Aam Aadmi Party,82352,137,82489,6
Maharashtra,Satara,UMESH MUKUND WAGHMARE,Independent,4711,0,4711,7
Maharashtra,Satara,KADAM SAGAR UTTAMRAO,Independent,10041,6,10047,8
Maharashtra,Satara,GAWDE SUKHDEV BHANUDAS,Independent,2434,1,2435,9
Maharashtra,Satara,PANDURANG RAMCHANDRA SHINDE,Independent,11302,2,11304,10
Maharashtra,Satara,PURUSHOTTAM JADHAV,Independent,155789,148,155937,11
Maharashtra,Satara,DR. PRAKASH SHAMRAO PAWAR,Independent,2162,2,2164,12
Maharashtra,Satara,BICHUKALE ABHIJIT VAMANRAO,Independent,3644,0,3644,13
Maharashtra,Satara,ADV. VARSHA  MADGULKAR,Independent,9395,10,9405,14
Maharashtra,Satara,DR. VIJAYSINHA  DILIPRAO PATIL,Independent,3649,5,3654,15
Maharashtra,Satara,SUBHASH NIVRUTTI SHILEWANT,Independent,15072,1,15073,16
Maharashtra,Satara,SUHAS VISHWASRAO DESHMUKH,Independent,12120,2,12122,17
Maharashtra,Satara,SANDIP AMRUTRAO MOZAR,Independent,18207,8,18215,18
Maharashtra,Satara,None of the Above,NOTA,10552,37,10589,19
Maharashtra,Ratnagiri - sindhudurg,AYARE RAJENDRA LAHU,Bahujan Samaj Party,13084,4,13088,1
Maharashtra,Ratnagiri - sindhudurg,NILESH NARAYAN RANE,Indian National Congress,342999,38,343037,2
Maharashtra,Ratnagiri - sindhudurg,VINAYAK BHAURAO RAUT,Shivsena,492900,188,493088,3
Maharashtra,Ratnagiri - sindhudurg,ABHIJIT SHRIRAM HEGSHETYE,Aam Aadmi Party,12693,7,12700,4
Maharashtra,Ratnagiri - sindhudurg,ADV. DIPAK DATTARAM NEVGI,Socialist Party (India),2904,0,2904,5
Maharashtra,Ratnagiri - sindhudurg,BIRJE YASHWANT ANANT,Bahujan Mukti Party,1992,0,1992,6
Maharashtra,Ratnagiri - sindhudurg,VINOD HANUMANTRAO SAWANT,Akhil Bharat Hindu Mahasabha,1395,0,1395,7
Maharashtra,Ratnagiri - sindhudurg,AJINKYA DHONDU GAWADE,Independent,2331,1,2332,8
Maharashtra,Ratnagiri - sindhudurg,ARUN HARISHCHANDRA MANJREKAR,Independent,5999,0,5999,9
Maharashtra,Ratnagiri - sindhudurg,SUNIL ALIAS YASHWANT VASANT PEDNEKAR,Independent,7328,0,7328,10
Maharashtra,Ratnagiri - sindhudurg,None of the Above,NOTA,12392,1,12393,11
Maharashtra,Kolhapur,KURANE AJAY PRAKASH,Bahujan Samaj Party,9285,6,9291,1
Maharashtra,Kolhapur,DHANANJAY BHIMRAO MAHADIK,Nationalist Congress Party,607184,481,607665,2
Maharashtra,Kolhapur,SANJAY SADASHIV MANDALIK,Shivsena,573642,764,574406,3
Maharashtra,Kolhapur,DR. JADHAV DAYANAND VASANT,Bahujan Mukti Party,8633,2,8635,4
Maharashtra,Kolhapur,ATUL PRASANNAKUMAR DIGHE,Bharipa Bahujan Mahasangha,7066,1,7067,5
Maharashtra,Kolhapur,NARAYAN GUNDU POWAR,Aam Aadmi Party,5469,26,5495,6
Maharashtra,Kolhapur,MHAMANE ANIL SUBHASH,MVA,736,0,736,7
Maharashtra,Kolhapur,SAMPATRAO SHAMRAO PAWAR PATIL,Peasants And Workers Party of India,13154,8,13162,8
Maharashtra,Kolhapur,KAMBLE SUKUMAR DATTU,Independent,915,0,915,9
Maharashtra,Kolhapur,PANDURANG TUKARAM CHOUGALE,Independent,835,1,836,10
Maharashtra,Kolhapur,JEEVAN ALIAS C.A.PATIL,Independent,898,0,898,11
Maharashtra,Kolhapur,YASHWANT BALKRUSHNA JOSHI,Independent,1415,0,1415,12
Maharashtra,Kolhapur,PATIL BAJRANG KRISHNA,Independent,5676,0,5676,13
Maharashtra,Kolhapur,SHEREGAR CHETAN VENKATESH,Independent,6114,0,6114,14
Maharashtra,Kolhapur,SANDEEP GUNDOPANT SANKPAL,Independent,10963,0,10963,15
Maharashtra,Kolhapur,None of the Above,NOTA,7001,14,7015,16
Maharashtra,Hatkanangle,AWADE KALLAPPA BABURAO,Indian National Congress,461835,783,462618,1
Maharashtra,Hatkanangle,KAMBLE CHANDRAKANT TUKARAM,Bahujan Samaj Party,11481,18,11499,2
Maharashtra,Hatkanangle,DIGAMBAR ALIAS GABBAR SUDAM SAKAT,Bharipa Bahujan Mahasangha,5183,3,5186,3
Maharashtra,Hatkanangle,YUVRAJ SHIVAJI KAMBLE,Bahujan Mukti Party,6574,11,6585,4
Maharashtra,Hatkanangle,RAGHUNATHDADA PATIL,Aam Aadmi Party,8979,36,9015,5
Maharashtra,Hatkanangle,RAJU SHETTY,Swabhimani Paksha,639191,1237,640428,6
Maharashtra,Hatkanangle,SHAIKH SHABBIR NABI,MPS(T),4170,6,4176,7
Maharashtra,Hatkanangle,KAMBLE SUKUMAR DATTU,Independent,2340,2,2342,8
Maharashtra,Hatkanangle,THORAT ANANDRAO TUKARAM,Independent,2637,0,2637,9
Maharashtra,Hatkanangle,PATIL S R TATYA,Independent,3317,1,3318,10
Maharashtra,Hatkanangle,MANE ARVIND BHIVA,Independent,2361,0,2361,11
Maharashtra,Hatkanangle,SURESHDADA PATIL,Independent,25625,23,25648,12
Maharashtra,Hatkanangle,SUSHANT SANTOSH DIGE,Independent,2999,0,2999,13
Maharashtra,Hatkanangle,None of the Above,NOTA,10035,24,10059,14
Manipur,Inner manipur,DR. THOKCHOM MEINYA,Indian National Congress,292085,17,292102,1
Manipur,Inner manipur,MOIRANGTHEM NARA,Communist Party of India,197420,8,197428,2
Manipur,Inner manipur,R.K. RANJAN SINGH,Bharatiya Janata Party,92431,13,92444,3
Manipur,Inner manipur,SARANGTHEM MANAOBI,All India Trinamool Congress,39903,0,39903,4
Manipur,Inner manipur,DR. IBOMCHA SINGH,Aam Aadmi Party,3271,2,3273,5
Manipur,Inner manipur,OINAM JOTIN SINGH,Jai Maha Bharath Party,1403,0,1403,6
Manipur,Inner manipur,DR. GURUMAYUM TONSANA SHARMA,MDPF,2004,1,2005,7
Manipur,Inner manipur,INDIRA OINAM,Independent,7013,1,7014,8
Manipur,Inner manipur,None of the Above,NOTA,5298,0,5298,9
Manipur,Outer manipur,KIM GANGTE,All India Trinamool Congress,12741,11,12752,1
Manipur,Outer manipur,GANGMUMEI KAMEI,Bharatiya Janata Party,75815,13,75828,2
Manipur,Outer manipur,CHUNGKHOKAI DOUNGEL,Nationalist Congress Party,61655,7,61662,3
Manipur,Outer manipur,THANGSO BAITE,Indian National Congress,296618,152,296770,4
Manipur,Outer manipur,SOSO LORHO,Nagaland Peoples Front,281121,12,281133,5
Manipur,Outer manipur,M. KHAMCHINPAU @ K. ZOU,Aam Aadmi Party,4328,3,4331,6
Manipur,Outer manipur,LAMMINLIEN @ LIEN GANGTE,Janata Dal (United),1085,0,1085,7
Manipur,Outer manipur,AMARSON SANKHIL,Independent,401,0,401,8
Manipur,Outer manipur,MANI CHARENAMEI,Independent,34995,0,34995,9
Manipur,Outer manipur,LAMLALMOI @ MOMOI GANGTE,Independent,603,0,603,10
Manipur,Outer manipur,None of the Above,NOTA,2206,0,2206,11
Meghalaya,Shillong,PAUL LYNGDOH,United Democratic Party,106806,11,106817,1
Meghalaya,Shillong,RICHARD D. SHABONG,Communist Party of India,7418,0,7418,2
Meghalaya,Shillong,SHIBUN LYNGDOH,Bharatiya Janata Party,95959,20,95979,3
Meghalaya,Shillong,VINCENT H. PALA,Indian National Congress,209288,52,209340,4
Meghalaya,Shillong,ARMERINGTON KHARSHIING,Aam Aadmi Party,8812,3,8815,5
Meghalaya,Shillong,DENIS SIANGSHAI,Independent,5092,0,5092,6
Meghalaya,Shillong,IVORYNA SHYLLA,Independent,6602,3,6605,7
Meghalaya,Shillong,PRECHARD B. M. BASAIAWMOIT,Independent,168940,21,168961,8
Meghalaya,Shillong,None of the Above,NOTA,10949,11,10960,9
Meghalaya,Tura ,DARYL WILLIAM CH MOMIN,Indian National Congress,199568,17,199585,1
Meghalaya,Tura ,PURNO AGITOK SANGMA,NPEP,239239,62,239301,2
Meghalaya,Tura ,None of the Above,NOTA,19182,3,19185,3
Mizoram,MIZORAM,C. L. RUALA,Indian National Congress,209573,912,210485,1
Mizoram,MIZORAM,M.LALMANZUALA,Aam Aadmi Party,11515,375,11890,2
Mizoram,MIZORAM,ROBERT ROMAWIA ROYTE,Independent,198203,6128,204331,3
Mizoram,MIZORAM,None of the Above,NOTA,6410,85,6495,4
Nagaland,Nagaland,NEIPHIU RIO,Nagaland Peoples Front,712888,484,713372,1
Nagaland,Nagaland,K. V. PUSA,Indian National Congress,313088,59,313147,2
Nagaland,Nagaland,AKHEI ACHUMI,Socialist Party (India),9690,5,9695,3
Nagaland,Nagaland,None of the Above,NOTA,2695,1,2696,4
Punjab,Gurdaspur,SUKHWINDER SINGH,Bahujan Samaj Party,5620,1,5621,1
Punjab,Gurdaspur,PARTAP SINGH BAJWA,Indian National Congress,346143,47,346190,2
Punjab,Gurdaspur,VARINDER SINGH,Communist Party of India,11839,0,11839,3
Punjab,Gurdaspur,VINOD KHANNA,Bharatiya Janata Party,482042,213,482255,4
Punjab,Gurdaspur,SANTOSH KUMARI,MEDP,3645,0,3645,5
Punjab,Gurdaspur,SUCHA SINGH CHHOTEPUR,Aam Aadmi Party,173287,89,173376,6
Punjab,Gurdaspur,GURPREET SINGH KHANNA,BGTD,1785,0,1785,7
Punjab,Gurdaspur,GURMEET SINGH BAKHATPURA,Communist Party of India (Marxist-Lenninist) (Liberation),2875,0,2875,8
Punjab,Gurdaspur,PETER MASIH,Sarvajan Samaj Party (D),1463,0,1463,9
Punjab,Gurdaspur,AMIT AGGARWAL,Independent,1195,0,1195,10
Punjab,Gurdaspur,SIKANDER SINGH,Independent,2124,0,2124,11
Punjab,Gurdaspur,MUKESH,Independent,1649,0,1649,12
Punjab,Gurdaspur,ROHIT MAINGI,Independent,4057,0,4057,13
Punjab,Gurdaspur,None of the Above,NOTA,4625,0,4625,14
Punjab,Amritsar,AMARJIT SINGH ASAL,Communist Party of India,12902,0,12902,1
Punjab,Amritsar,CAPTAIN AMARINDER SINGH,Indian National Congress,482854,22,482876,2
Punjab,Amritsar,ARUN JAITLEY,Bharatiya Janata Party,380057,49,380106,3
Punjab,Amritsar,PARDEEP SINGH WALIA,Bahujan Samaj Party,5869,1,5870,4
Punjab,Amritsar,SURINDER SINGH,DCP,833,0,833,5
Punjab,Amritsar,KRISHAN SHARMA,NBDP,503,0,503,6
Punjab,Amritsar,GURDIAL SINGH GILL,DBSP,604,0,604,7
Punjab,Amritsar,DR. DALJIT SINGH,Aam Aadmi Party,82619,14,82633,8
Punjab,Amritsar,BALBIR SINGH,BGTD,827,0,827,9
Punjab,Amritsar,BUTA SINGH,BSP(A),941,0,941,10
Punjab,Amritsar,YUSAF MOHAMMAD,Samajwadi Party,922,0,922,11
Punjab,Amritsar,AMARINDER SINGH,Independent,1151,0,1151,12
Punjab,Amritsar,ARUN KUMAR JOSHI,Independent,9023,0,9023,13
Punjab,Amritsar,DR. INDERPAL,Independent,3083,0,3083,14
Punjab,Amritsar,SHAM LAL GANDHIWADI,Independent,2691,0,2691,15
Punjab,Amritsar,SURINDER KUMAR KHOSLA,Independent,2396,0,2396,16
Punjab,Amritsar,KANWALJIT SINGH SAHOTA,Independent,2123,0,2123,17
Punjab,Amritsar,GAGANDEEP KUMAR,Independent,3294,0,3294,18
Punjab,Amritsar,BAL KRISHAN SHARMA,Independent,2878,0,2878,19
Punjab,Amritsar,BHAGWANT SINGH,Independent,2303,0,2303,20
Punjab,Amritsar,MOHINDER SINGH,Independent,1140,0,1140,21
Punjab,Amritsar,REHMAT MASIH,Independent,1214,0,1214,22
Punjab,Amritsar,RATTAN SINGH RANDHAWA,Independent,4350,0,4350,23
Punjab,Amritsar,None of the Above,NOTA,2533,0,2533,24
Punjab,Khadoor Sahib,SUCHA SINGH MANN,Bahujan Samaj Party,8490,1,8491,1
Punjab,Khadoor Sahib,HARMINDER SINGH GILL,Indian National Congress,366742,21,366763,2
Punjab,Khadoor Sahib,RANJIT SINGH BRAHMPURA,Shiromani Akali Dal,467238,94,467332,3
Punjab,Khadoor Sahib,STEPHEN MASIH,Sarvajan Samaj Party (D),4329,0,4329,4
Punjab,Khadoor Sahib,SIMRANJIT SINGH MANN,Shiromani Akali Dal (Amritsar)(Sim,13982,8,13990,5
Punjab,Khadoor Sahib,SUKHCHAIN CHAND,DBSP,1313,0,1313,6
Punjab,Khadoor Sahib,GURPAL SINGH,aimpr,1182,0,1182,7
Punjab,Khadoor Sahib,BALDEEP SINGH,Aam Aadmi Party,144441,80,144521,8
Punjab,Khadoor Sahib,BALWANT SINGH SULTANPURI,BSP(A),2930,0,2930,9
Punjab,Khadoor Sahib,SUKHDEV SINGH CHOHAN,Independent,801,0,801,10
Punjab,Khadoor Sahib,SUKHWANT SINGH,Independent,1053,0,1053,11
Punjab,Khadoor Sahib,KAWALJIT SINGH,Independent,962,0,962,12
Punjab,Khadoor Sahib,GURNAM SINGH,Independent,9307,0,9307,13
Punjab,Khadoor Sahib,JASBIR SINGH,Independent,3114,0,3114,14
Punjab,Khadoor Sahib,BALWINDER SINGH,Independent,3804,0,3804,15
Punjab,Khadoor Sahib,BHUPINDER SINGH,Independent,3282,0,3282,16
Punjab,Khadoor Sahib,MAHINDER SINGH HAMIRA,Independent,1720,0,1720,17
Punjab,Khadoor Sahib,None of the Above,NOTA,5624,0,5624,18
Punjab,Jalandhar,SANTOKH SINGH CHAUDHARY,Indian National Congress,380467,12,380479,1
Punjab,Jalandhar,SUKHWINDER SINGH KOTLI,Bahujan Samaj Party,46913,1,46914,2
Punjab,Jalandhar,PAWAN KUMAR TINU,Shiromani Akali Dal,309478,20,309498,3
Punjab,Jalandhar,SUBHASH GORIA,Shivsena,3496,1,3497,4
Punjab,Jalandhar,JARNAIL SINGH,BhJaSP,1178,0,1178,5
Punjab,Jalandhar,JYOTI MANN,Aam Aadmi Party,254104,17,254121,6
Punjab,Jalandhar,TARA SINGH GILL,BSP(A),2267,1,2268,7
Punjab,Jalandhar,PARAMJIT KUMAR,Bahujan Mukti Party,717,0,717,8
Punjab,Jalandhar,VIJAY HANS,DBSP,1192,0,1192,9
Punjab,Jalandhar,AJAY KUMAR BHAGAT,Independent,692,0,692,10
Punjab,Jalandhar,AMIT JASSI,Independent,779,0,779,11
Punjab,Jalandhar,KAMAL THAPAR,Independent,933,0,933,12
Punjab,Jalandhar,KULDIP KUMAR,Independent,953,0,953,13
Punjab,Jalandhar,K.K. SABHARWAL,Independent,1454,0,1454,14
Punjab,Jalandhar,JAGAN NATH BAJWA,Independent,1082,0,1082,15
Punjab,Jalandhar,TARSEM PETER,Independent,6250,0,6250,16
Punjab,Jalandhar,DARSHAN NAHAR,Independent,10074,0,10074,17
Punjab,Jalandhar,DHARMINDER,Independent,2458,0,2458,18
Punjab,Jalandhar,NIRMAL SINGH BOLINA,Independent,2257,0,2257,19
Punjab,Jalandhar,MANJEET KAUR W/O SUKHDEV SINGH,Independent,1952,0,1952,20
Punjab,Jalandhar,MANJIT KAUR W/O SUKHWINDER SINGH,Independent,1044,0,1044,21
Punjab,Jalandhar,LOVE KISHOR,Independent,3265,0,3265,22
Punjab,Jalandhar,VIJAY KUMAR,Independent,1528,0,1528,23
Punjab,Jalandhar,VIVEK,Independent,741,0,741,24
Punjab,Jalandhar,None of the Above,NOTA,5435,1,5436,25
Punjab,Hoshiarpur,BHAGWAN SINGH CHAUHAN,Bahujan Samaj Party,40483,14,40497,1
Punjab,Hoshiarpur,MOHINDER SINGH KAYPEE,Indian National Congress,332927,134,333061,2
Punjab,Hoshiarpur,VIJAY SAMPLA,Bharatiya Janata Party,346341,302,346643,3
Punjab,Hoshiarpur,ANOOP SINGH,BhJaSP,2156,2,2158,4
Punjab,Hoshiarpur,SHAMSHER SINGH,Shiromani Akali Dal (Amritsar)(Sim,2520,7,2527,5
Punjab,Hoshiarpur,JASWINDER SINGH,Shivsena,1230,0,1230,6
Punjab,Hoshiarpur,DEEPAK KUMAR,Bahujan Mukti Party,1446,0,1446,7
Punjab,Hoshiarpur,YAMINI GOMAR,Aam Aadmi Party,213154,234,213388,8
Punjab,Hoshiarpur,LAKHVIR SINGH,DBSP,1061,1,1062,9
Punjab,Hoshiarpur,VIJAY KUMAR,Sarvajan Samaj Party (D),888,1,889,10
Punjab,Hoshiarpur,OM PARKASH JAKHU,Independent,699,0,699,11
Punjab,Hoshiarpur,ANU KUMAR,Independent,910,1,911,12
Punjab,Hoshiarpur,DAVINDER SINGH,Independent,1488,0,1488,13
Punjab,Hoshiarpur,PAWAN KUMAR,Independent,3216,0,3216,14
Punjab,Hoshiarpur,BISHAN DASS,Independent,1853,0,1853,15
Punjab,Hoshiarpur,RAVI DUTT,Independent,2564,0,2564,16
Punjab,Hoshiarpur,RAM KISHAN,Independent,1689,0,1689,17
Punjab,Hoshiarpur,None of the Above,NOTA,5975,1,5976,18
Punjab,Anandpur Sahib,AMBIKA SONI,Indian National Congress,323660,37,323697,1
Punjab,Anandpur Sahib,K.S.MAKHAN,Bahujan Samaj Party,69106,18,69124,2
Punjab,Anandpur Sahib,PREM SINGH CHANDUMAJRA,Shiromani Akali Dal,347347,47,347394,3
Punjab,Anandpur Sahib,BALBIR SINGH JADLA,Communist Party of India  (Marxist),10483,0,10483,4
Punjab,Anandpur Sahib,HIMMAT SINGH SHERGILL,Aam Aadmi Party,305944,64,306008,5
Punjab,Anandpur Sahib,JASWANT SINGH MANN,Shiromani Akali Dal (Amritsar)(Sim,1701,5,1706,6
Punjab,Anandpur Sahib,RAMESH RANI PARJAPATI,Bahujan Mukti Party,718,0,718,7
Punjab,Anandpur Sahib,RESHAM KAHLON,BA S D,837,0,837,8
Punjab,Anandpur Sahib,HARCHARAN SINGH,Independent,1423,0,1423,9
Punjab,Anandpur Sahib,GURSHARN SINGH PANESAR,Independent,1943,0,1943,10
Punjab,Anandpur Sahib,GURNAM SINGH,Independent,722,0,722,11
Punjab,Anandpur Sahib,GURMEET SINGH,Independent,1010,0,1010,12
Punjab,Anandpur Sahib,DALJIT SINGH,Independent,2713,0,2713,13
Punjab,Anandpur Sahib,DAVINDER KUMAR VERMA,Independent,1995,0,1995,14
Punjab,Anandpur Sahib,NAVNEET CHAUTALA,Independent,1307,0,1307,15
Punjab,Anandpur Sahib,FAQIR CHAND KARIHA,Independent,3869,0,3869,16
Punjab,Anandpur Sahib,BALJIT KAUR,Independent,4250,0,4250,17
Punjab,Anandpur Sahib,MANDEEP SINGH BITTU,Independent,1427,0,1427,18
Punjab,Anandpur Sahib,None of the Above,NOTA,5936,1,5937,19
Punjab,Ludhiana,SUKHWINDER SINGH SEKHON,Communist Party of India  (Marxist),4166,1,4167,1
Punjab,Ludhiana,NAVJOT SINGH MANDAIR,Bahujan Samaj Party,8314,3,8317,2
Punjab,Ludhiana,MANPREET SINGH AYALI,Shiromani Akali Dal,256544,46,256590,3
Punjab,Ludhiana,RAVNEET SINGH BITTU,Indian National Congress,300424,35,300459,4
Punjab,Ludhiana,AKSHAYBAR NATH MISHRA,Janata Dal (United),2925,0,2925,5
Punjab,Ludhiana,HARVINDER SINGH PHOOLKA,Aam Aadmi Party,280635,115,280750,6
Punjab,Ludhiana,HARI RAM SAHNI,All India Forward Bloc,1168,0,1168,7
Punjab,Ludhiana,KISHAN KUMAR SHARMA,Jammu & Kashmir National Panthers Party,1483,0,1483,8
Punjab,Ludhiana,DARSHAN SINGH,Shivsena,1028,0,1028,9
Punjab,Ludhiana,MOHD. NASEEM ANSARI,aicp,1984,0,1984,10
Punjab,Ludhiana,BITTU,Republican Party of India (A),1286,0,1286,11
Punjab,Ludhiana,MOHAMMAD MAKSOOD ANSARI,Bahujan Mukti Party,1111,0,1111,12
Punjab,Ludhiana,SIMERJIT SINGH,Independent,3980,0,3980,13
Punjab,Ludhiana,SIMARJEET SINGH BAINS,Independent,210895,22,210917,14
Punjab,Ludhiana,KULWINDER PAL SINGH,Independent,986,0,986,15
Punjab,Ludhiana,GURDEEP SINGH KAHLON,Independent,4509,0,4509,16
Punjab,Ludhiana,JASWINDER SINGH BAINS,Independent,3238,0,3238,17
Punjab,Ludhiana,JAI PARKASH JAIN,Independent,1519,0,1519,18
Punjab,Ludhiana,TARSEM SINGH BANGA,Independent,1934,0,1934,19
Punjab,Ludhiana,NAVPREET SINGH BEDI,Independent,3144,0,3144,20
Punjab,Ludhiana,RAJ KUMAR ATWAL,Independent,1089,0,1089,21
Punjab,Ludhiana,RAJIV KUMAR KALRA,Independent,4653,0,4653,22
Punjab,Ludhiana,None of the Above,NOTA,3219,1,3220,23
Punjab,Fatehgarh Sahib,SARABJEET SINGH,Bahujan Samaj Party,12681,2,12683,1
Punjab,Fatehgarh Sahib,SADHU SINGH,Indian National Congress,313128,21,313149,2
Punjab,Fatehgarh Sahib,KULWANT SINGH,Shiromani Akali Dal,312782,33,312815,3
Punjab,Fatehgarh Sahib,NIRMAL SINGH,Nationalist Congress Party,2149,0,2149,4
Punjab,Fatehgarh Sahib,HARPREET SINGH,Bahujan Mukti Party,2352,0,2352,5
Punjab,Fatehgarh Sahib,HARINDER SINGH KHALSA,Aam Aadmi Party,367231,62,367293,6
Punjab,Fatehgarh Sahib,GURDEEP SINGH,IVD,1930,0,1930,7
Punjab,Fatehgarh Sahib,DHARAM SINGH,Shiromani Akali Dal (Amritsar)(Sim,3173,0,3173,8
Punjab,Fatehgarh Sahib,LAKHVIR SINGH,Jammu & Kashmir National Panthers Party,1733,0,1733,9
Punjab,Fatehgarh Sahib,AVTAR SINGH,Independent,848,0,848,10
Punjab,Fatehgarh Sahib,PARAMJIT SINGH,Independent,1266,0,1266,11
Punjab,Fatehgarh Sahib,MANPREET SINGH,Independent,886,0,886,12
Punjab,Fatehgarh Sahib,RANJIT SINGH,Independent,1679,0,1679,13
Punjab,Fatehgarh Sahib,LACHHMAN SINGH S/O S.SAROOP SINGH,Independent,2852,0,2852,14
Punjab,Fatehgarh Sahib,LACHHMAN SINGH S/O S.GULZAR SINGH,Independent,2141,0,2141,15
Punjab,Fatehgarh Sahib,None of the Above,NOTA,4005,0,4005,16
Punjab,Faridkot,SANT RAM,Bahujan Samaj Party,8279,3,8282,1
Punjab,Faridkot,KASHMIR SINGH,Communist Party of India,14573,0,14573,2
Punjab,Faridkot,JOGINDER SINGH,Indian National Congress,251170,52,251222,3
Punjab,Faridkot,PARAMJIT KAUR GULSHAN,Shiromani Akali Dal,277956,279,278235,4
Punjab,Faridkot,SATPAL SINGH,IKL,3680,0,3680,5
Punjab,Faridkot,PROF. SADHU SINGH,Aam Aadmi Party,450632,119,450751,6
Punjab,Faridkot,GURCHARAN SINGH,Republican Party of India,1531,0,1531,7
Punjab,Faridkot,GOBIND SINGH,Republican Party of India (A),864,1,865,8
Punjab,Faridkot,JARNAIL SINGH,NBDP,1358,0,1358,9
Punjab,Faridkot,DARSHAN SINGH,Shiromani Akali Dal (Amritsar)(Sim,1604,1,1605,10
Punjab,Faridkot,PARAMJIT KAUR W/O AMRIK SINGH,Bahujan Mukti Party,1159,0,1159,11
Punjab,Faridkot,MANGAT RAM MANGA,Shivsena,2213,0,2213,12
Punjab,Faridkot,MOTI LAL,BhSMP,1511,1,1512,13
Punjab,Faridkot,SEEMA RANI,Independent,1726,0,1726,14
Punjab,Faridkot,JASVEER SINGH,Independent,1693,0,1693,15
Punjab,Faridkot,JOGINDER SINGH S/O KESAR SINGH,Independent,2667,0,2667,16
Punjab,Faridkot,PARAMJEET KAUR W/O GURPREET SINGH,Independent,1623,0,1623,17
Punjab,Faridkot,BADAL SINGH,Independent,1123,0,1123,18
Punjab,Faridkot,REENA KUMARI,Independent,2473,0,2473,19
Punjab,Faridkot,None of the Above,NOTA,3816,0,3816,20
Punjab,Firozpur,SUNIL JAKHAR,Indian National Congress,456401,111,456512,1
Punjab,Firozpur,SHER SINGH GHUBAYA,Shiromani Akali Dal,487737,195,487932,2
Punjab,Firozpur,RAM KUMAR PARJAPAT,Bahujan Samaj Party,22265,9,22274,3
Punjab,Firozpur,SATNAM PAUL KAMBOJ,Aam Aadmi Party,113297,115,113412,4
Punjab,Firozpur,DHIAN SINGH MAND,Shiromani Akali Dal (Amritsar)(Sim,3654,1,3655,5
Punjab,Firozpur,BALJINDER SINGH,BGTD,681,0,681,6
Punjab,Firozpur,SWARAN SINGH,Independent,766,0,766,7
Punjab,Firozpur,SAMPURAN SINGH,Independent,682,0,682,8
Punjab,Firozpur,GURJANT SINGH,Independent,1088,0,1088,9
Punjab,Firozpur,CHANAN SINGH WATTU,Independent,1237,0,1237,10
Punjab,Firozpur,PARAMJEET SINGH DESAL,Independent,976,0,976,11
Punjab,Firozpur,PANJAB SINGH KATWAL,Independent,1759,0,1759,12
Punjab,Firozpur,MANOJ KUMAR MONGA,Independent,1896,0,1896,13
Punjab,Firozpur,RAJINDER BHATHEJA,Independent,1546,0,1546,14
Punjab,Firozpur,RAJ GILL,Independent,3311,0,3311,15
Punjab,Firozpur,None of the Above,NOTA,7677,8,7685,16
Punjab,Bathinda,HARSIMRAT KAUR BADAL,Shiromani Akali Dal,514562,165,514727,1
Punjab,Bathinda,KULDEEP SINGH,Bahujan Samaj Party,13731,1,13732,2
Punjab,Bathinda,MANPREET SINGH BADAL S/O GURDAS SINGH,Indian National Congress,495232,100,495332,3
Punjab,Bathinda,SHAMINDER SINGH,Jammu & Kashmir National Panthers Party,4610,0,4610,4
Punjab,Bathinda,SUKHWINDER SINGH,Bahujan Mukti Party,1081,5,1086,5
Punjab,Bathinda,SURESH KUMAR GOYAL,JanSP,944,0,944,6
Punjab,Bathinda,GEETA RANI,Akhil Bharatiya Shivsena Rashtrawadi,4380,0,4380,7
Punjab,Bathinda,GURDEEP SINGH,IKL,1404,0,1404,8
Punjab,Bathinda,GURMEET SINGH RANGHRETA,PLP,1385,1,1386,9
Punjab,Bathinda,JASRAJ SINGH LONGIA,Aam Aadmi Party,87844,57,87901,10
Punjab,Bathinda,JAGDISH RAI SHARMA,NBDP,1248,0,1248,11
Punjab,Bathinda,NAVNEET,Shivsena,1888,5,1893,12
Punjab,Bathinda,BHAGWANT SINGH SAMAON,Communist Party of India (Marxist-Lenninist) (Liberation),5984,0,5984,13
Punjab,Bathinda,MAKHAN LAL,BSP(A),2587,0,2587,14
Punjab,Bathinda,RAJINDER SINGH,Shiromani Akali Dal (Amritsar)(Sim,1959,1,1960,15
Punjab,Bathinda,ASHISH,Independent,6626,0,6626,16
Punjab,Bathinda,SATISH ARORA,Independent,5936,0,5936,17
Punjab,Bathinda,SWARAN SINGH,Independent,2077,0,2077,18
Punjab,Bathinda,SANJEEV KUMAR THAPAR,Independent,2833,0,2833,19
Punjab,Bathinda,SUSHIL KUMAR JINDAL,Independent,1330,0,1330,20
Punjab,Bathinda,KARTAR SINGH,Independent,916,0,916,21
Punjab,Bathinda,GURCHARAN SINGH,Independent,820,0,820,22
Punjab,Bathinda,JASPAL SINGH,Independent,703,0,703,23
Punjab,Bathinda,JAGDEEP SINGH,Independent,668,0,668,24
Punjab,Bathinda,JAGDEEP SINGH GEHRI,Independent,1665,0,1665,25
Punjab,Bathinda,DYAL CHAND,Independent,955,0,955,26
Punjab,Bathinda,BHUPESH KUMAR,Independent,1487,0,1487,27
Punjab,Bathinda,MANPREET SINGH BADAL S/O GURDEV SINGH,Independent,4617,1,4618,28
Punjab,Bathinda,VIJAY KUMAR,Independent,2257,1,2258,29
Punjab,Bathinda,None of the Above,NOTA,4699,2,4701,30
Punjab,Sangrur,SUKHDEV SINGH DHINDSA,Shiromani Akali Dal,321471,45,321516,1
Punjab,Sangrur,SUKHDEV RAM SHARMA,Communist Party of India,6934,0,6934,2
Punjab,Sangrur,JOGINDER SINGH AULAKH,Communist Party of India  (Marxist),3315,0,3315,3
Punjab,Sangrur,MADAN BHATTI,Bahujan Samaj Party,8405,3,8408,4
Punjab,Sangrur,VIJAY INDER SINGLA,Indian National Congress,181401,9,181410,5
Punjab,Sangrur,KARNAIL SINGH,Shiromani Akali Dal (Amritsar)(Sim,4126,1,4127,6
Punjab,Sangrur,GURDEEP SINGH,DBSP,1069,0,1069,7
Punjab,Sangrur,GURPREET SINGH,Communist Party of India (Marxist-Lenninist) (Liberation),2746,0,2746,8
Punjab,Sangrur,JASWANT SINGH,Bahujan Mukti Party,1556,0,1556,9
Punjab,Sangrur,JIT SINGH,Communist Party of India (Marxist),5879,0,5879,10
Punjab,Sangrur,BHAGWANT MANN,Aam Aadmi Party,533191,46,533237,11
Punjab,Sangrur,MAHMOOD AHMED THIND,Indian Union Muslim League,2261,0,2261,12
Punjab,Sangrur,SUKHDEV SINGH,Independent,1233,0,1233,13
Punjab,Sangrur,HARINDER KUMAR,Independent,1486,0,1486,14
Punjab,Sangrur,KARAM SINGH,Independent,1601,0,1601,15
Punjab,Sangrur,JOTI DEVAJI ANSUIA,Independent,6830,0,6830,16
Punjab,Sangrur,DHARAM SINGH,Independent,3290,0,3290,17
Punjab,Sangrur,PARVEEN KAUR,Independent,798,0,798,18
Punjab,Sangrur,BIJENDER,Independent,5395,0,5395,19
Punjab,Sangrur,BHAGWANT SINGH,Independent,2334,0,2334,20
Punjab,Sangrur,MANOJ KUMAR,Independent,1854,0,1854,21
Punjab,Sangrur,None of the Above,NOTA,2188,0,2188,22
Punjab,Patiala,DEEPINDER SINGH DHILLON,Shiromani Akali Dal,340092,17,340109,1
Punjab,Patiala,NIRMAL SINGH DHALIWAL,Communist Party of India,8537,0,8537,2
Punjab,Patiala,PRENEET KAUR,Indian National Congress,344715,14,344729,3
Punjab,Patiala,RAM SINGH DHIMAN,Bahujan Samaj Party,13014,0,13014,4
Punjab,Patiala,AMRIK SINGH,aicp,936,0,936,5
Punjab,Patiala,HARISH KUMAR,Shivsena,2324,1,2325,6
Punjab,Patiala,GURPREET SINGH,BSP(A),2378,0,2378,7
Punjab,Patiala,DR. DHARAM VIRA GANDHI,Aam Aadmi Party,365644,27,365671,8
Punjab,Patiala,MOHINDER PAL SINGH,Shiromani Akali Dal (Amritsar)(Sim,2772,1,2773,9
Punjab,Patiala,RANJIT KAUR,BGTD,2178,0,2178,10
Punjab,Patiala,RANDHIR SINGH,Bahujan Mukti Party,1234,0,1234,11
Punjab,Patiala,RAVINDER SINGH,BhSMP,1177,0,1177,12
Punjab,Patiala,BIBI KAMALDEEP KAUR RAJOANA,Independent,15313,0,15313,13
Punjab,Patiala,GURBHEJ SINGH,Independent,2217,0,2217,14
Punjab,Patiala,DHARAM PAL,Independent,1271,0,1271,15
Punjab,Patiala,PARVEEN KUMAR,Independent,4089,0,4089,16
Punjab,Patiala,PARVESH BHATEJA,Independent,4915,0,4915,17
Punjab,Patiala,RAJINDER SINGH PAWAR,Independent,1625,0,1625,18
Punjab,Patiala,RAMISHER SINGH BILLA,Independent,2625,0,2625,19
Punjab,Patiala,LAKHWINDER SINGH MALHI,Independent,809,0,809,20
Punjab,Patiala,None of the Above,NOTA,3008,0,3008,21
Rajasthan,Ganganagar,NIHALCHAND,Bharatiya Janata Party,654306,3824,658130,1
Rajasthan,Ganganagar,PALARAM,Communist Party of India  (Marxist),14926,18,14944,2
Rajasthan,Ganganagar,MASTER BHANWARLAL MEGHWAL,Indian National Congress,365698,691,366389,3
Rajasthan,Ganganagar,AMAR SINGH,Bahujan Mukti Party,6672,14,6686,4
Rajasthan,Ganganagar,ADVOCATE KARTAR SINGH BAINS,All India Trinamool Congress,5019,6,5025,5
Rajasthan,Ganganagar,JASVINDER SINGH,Jai Maha Bharath Party,3394,1,3395,6
Rajasthan,Ganganagar,DR. PALUSKAR K. T.,PRCP,5223,9,5232,7
Rajasthan,Ganganagar,BALWANT SINGH HARIYALA,BhSMP,5363,1,5364,8
Rajasthan,Ganganagar,DR. BALKRISHAN BAWARI,Aam Aadmi Party,39809,207,40016,9
Rajasthan,Ganganagar,SHIMLA DEVI NAYAK (ADVOCATE),nuzp,106083,502,106585,10
Rajasthan,Ganganagar,SUNIL BHADRWAL,Lok Dal,3721,8,3729,11
Rajasthan,Ganganagar,HETRAM,Rajasthan Vikas Party,2931,12,2943,12
Rajasthan,Ganganagar,OM PARKASH,Independent,3747,3,3750,13
Rajasthan,Ganganagar,KUMBHA RAM,Independent,3005,2,3007,14
Rajasthan,Ganganagar,TITAR SINGH,Independent,3913,11,3924,15
Rajasthan,Ganganagar,DULICHAND MEGHWAL,Independent,11978,3,11981,16
Rajasthan,Ganganagar,BALRAJ BAWARI,Independent,8786,2,8788,17
Rajasthan,Ganganagar,None of the Above,NOTA,6876,42,6918,18
Rajasthan,Bikaner,ARJUN RAM MEGHWAL ,Bharatiya Janata Party,583455,1477,584932,1
Rajasthan,Bikaner,BHANWAR LAL,Bahujan Samaj Party,11369,18,11387,2
Rajasthan,Bikaner,ER. SHANKAR PANNU,Indian National Congress,276617,236,276853,3
Rajasthan,Bikaner,DR. GAURI SHANKER DAABI,Aam Aadmi Party,14105,43,14148,4
Rajasthan,Bikaner,MANGILAL NAYAK,nuzp,16813,26,16839,5
Rajasthan,Bikaner,RAM RATAN MEGHWAL,Bahujan Mukti Party,2537,1,2538,6
Rajasthan,Bikaner,GOPAL BALMIKI,Independent,4396,2,4398,7
Rajasthan,Bikaner,JAGDISH KUMAR NAYAK,Independent,5161,3,5164,8
Rajasthan,Bikaner,None of the Above,NOTA,13476,16,13492,9
Rajasthan,Churu,ABHINESH MAHARSHI,Bahujan Samaj Party,300508,509,301017,1
Rajasthan,Churu,INDRA SINGH JAT,Communist Party of India  (Marxist),10764,14,10778,2
Rajasthan,Churu,PRATAP SINGH,Indian National Congress,176621,291,176912,3
Rajasthan,Churu,RAHUL KASWAN ,Bharatiya Janata Party,593163,2593,595756,4
Rajasthan,Churu,KRISHAN KUMAR SARAN,Aam Aadmi Party,13889,88,13977,5
Rajasthan,Churu,GORDHAN SARSWAT,All India Trinamool Congress,3988,3,3991,6
Rajasthan,Churu,TORURAM MEGHWAL,Bahujan Mukti Party,2046,8,2054,7
Rajasthan,Churu,MOHAMMAD ALI KHAN,BA S D,2311,2,2313,8
Rajasthan,Churu,SYOPAT RAM,BhSMP,2330,0,2330,9
Rajasthan,Churu,AJAY KUMAR,Independent,2937,1,2938,10
Rajasthan,Churu,RAJPAL,Independent,3721,6,3727,11
Rajasthan,Churu,SALIM GUJAR,Independent,4017,1,4018,12
Rajasthan,Churu,None of the Above,NOTA,11279,14,11293,13
Rajasthan,Jhunjhunu,RAHISA BANO,Bahujan Samaj Party,10398,25,10423,1
Rajasthan,Jhunjhunu,RAJ BALA OLA,Indian National Congress,253495,852,254347,2
Rajasthan,Jhunjhunu,SANTOSH AHLAWAT,Bharatiya Janata Party,484630,3552,488182,3
Rajasthan,Jhunjhunu,URMILA,MEDP,5580,1,5581,4
Rajasthan,Jhunjhunu,OM PRAKASH JHARODA,Communist Party of India (Marxist-Lenninist) (Liberation),2503,3,2506,5
Rajasthan,Jhunjhunu,GENERAL R S KADYAN,Aam Aadmi Party,10283,103,10386,6
Rajasthan,Jhunjhunu,BHAN SINGH,BhSMP,1883,2,1885,7
Rajasthan,Jhunjhunu,BHUDAR MAL,All India Trinamool Congress,2979,0,2979,8
Rajasthan,Jhunjhunu,PRAVEEN KUMAR,Independent,1178,0,1178,9
Rajasthan,Jhunjhunu,MAHABEER PRASAD KUMAWAT,Independent,2930,2,2932,10
Rajasthan,Jhunjhunu,DR. RAJKUMAR SHARMA,Independent,205917,371,206288,11
Rajasthan,Jhunjhunu,RAJBALA,Independent,11734,6,11740,12
Rajasthan,Jhunjhunu,None of the Above,NOTA,8029,9,8038,13
Rajasthan,Sikar,AMARA RAM,Communist Party of India  (Marxist),53029,105,53134,1
Rajasthan,Sikar,GULAM NABI AZAD,Bahujan Samaj Party,4097,15,4112,2
Rajasthan,Sikar,PRATAP SINGH JAT,Indian National Congress,259374,858,260232,3
Rajasthan,Sikar,SUMEDHANAND SARASWATI ,Bharatiya Janata Party,496393,3035,499428,4
Rajasthan,Sikar,SWAMI BHAGIRATH SINGH KHARRANTE BHADHADAR,Akhil Bharat Hindu Mahasabha,5384,3,5387,5
Rajasthan,Sikar,RAMESH SHARMA,bhp,1630,5,1635,6
Rajasthan,Sikar,VIMAL INDORIA,Jai Maha Bharath Party,967,1,968,7
Rajasthan,Sikar,SATISH KUMAR SHARMA,JGP,1049,9,1058,8
Rajasthan,Sikar,MAJOR SURENDRA KUMAR PUNIA,Aam Aadmi Party,15560,106,15666,9
Rajasthan,Sikar,AJAYPAL,Independent,7033,3,7036,10
Rajasthan,Sikar,KANHAIYA LAL BALAI,Independent,2159,10,2169,11
Rajasthan,Sikar,DULI CHAND KUMAWAT,Independent,4371,4,4375,12
Rajasthan,Sikar,PRATAP SINGH,Independent,10662,4,10666,13
Rajasthan,Sikar,SUBHASH MAHARIA,Independent,187526,1315,188841,14
Rajasthan,Sikar,SURENDRA KUMAR PHULWARIYA,Independent,3631,2,3633,15
Rajasthan,Sikar,None of the Above,NOTA,7401,9,7410,16
Rajasthan,Jaipur Rural,DR. C.P. JOSHI,Indian National Congress,298208,1826,300034,1
Rajasthan,Jaipur Rural,RAJYAVARDHAN SINGH RATHORE ,Bharatiya Janata Party,629447,3483,632930,2
Rajasthan,Jaipur Rural,AJAY KUMAR SHARMA,JGP,5767,7,5774,3
Rajasthan,Jaipur Rural,ANIL KUMAR,Aam Aadmi Party,6847,70,6917,4
Rajasthan,Jaipur Rural,JAGDISH PRASAD,Lok Dal,1378,0,1378,5
Rajasthan,Jaipur Rural,TEK CHAND SONWAL,APoI,3035,12,3047,6
Rajasthan,Jaipur Rural,DHIRAJ GURJAR,Samajwadi Party,1401,11,1412,7
Rajasthan,Jaipur Rural,NAVIN PILANIA,NPEP,31455,162,31617,8
Rajasthan,Jaipur Rural,NARAYAN LAL PARIHAR,BNNP,1327,0,1327,9
Rajasthan,Jaipur Rural,SHAYAM SINGH RATHORE,LS,3722,0,3722,10
Rajasthan,Jaipur Rural,DR. OM SINGH MEENA,Independent,4518,2,4520,11
Rajasthan,Jaipur Rural,KAMAL  KUMAR  GAUR,Independent,9479,1,9480,12
Rajasthan,Jaipur Rural,None of the Above,NOTA,11527,6,11533,13
Rajasthan,Jaipur,D.K. (DEV KRISHAN) CHHANGANI,Communist Party of India,15594,3,15597,1
Rajasthan,Jaipur,FAROOQ SHAH,Bahujan Samaj Party,5177,16,5193,2
Rajasthan,Jaipur,DR. MAHESH JOSHI,Indian National Congress,323031,982,324013,3
Rajasthan,Jaipur,RAMCHARAN BOHARA,Bharatiya Janata Party,859973,3385,863358,4
Rajasthan,Jaipur,ANIL KUMAR SHARMA,JGP,4568,31,4599,5
Rajasthan,Jaipur,ABDUL AZIZ BHARTIYA,Rashtriya Ulama Council,1102,1,1103,6
Rajasthan,Jaipur,IFTEKAR QURISHI,All India Forward Bloc,621,0,621,7
Rajasthan,Jaipur,KAILASH CHAND SAINI,Hindustan Janta Party,565,1,566,8
Rajasthan,Jaipur,DR. TANMAY,IPGP,891,2,893,9
Rajasthan,Jaipur,NEERU AGARWAL,nuzp,1561,5,1566,10
Rajasthan,Jaipur,RAJU LAL BAIRWA,APoI,1891,8,1899,11
Rajasthan,Jaipur,DR. VIRENDRA SINGH,Aam Aadmi Party,54839,279,55118,12
Rajasthan,Jaipur,PAWAN SINGH SHEKHAWAT,Independent,1984,3,1987,13
Rajasthan,Jaipur,MUNNA DASS DABODIA,Independent,4852,4,4856,14
Rajasthan,Jaipur,RAM SINGH RAJ,Independent,2072,0,2072,15
Rajasthan,Jaipur,HAFIZ KHAN WARSI,Independent,5020,0,5020,16
Rajasthan,Jaipur,None of the Above,NOTA,8327,18,8345,17
Rajasthan,Alwar,AZAD HUSAIN,Bahujan Samaj Party,19473,10,19483,1
Rajasthan,Alwar,CHAND NATH,Bharatiya Janata Party,640481,1797,642278,2
Rajasthan,Alwar,BHANWAR JITENDRA SINGH,Indian National Congress,357609,774,358383,3
Rajasthan,Alwar,ARUN KUMAR ROOPAK,NADP,3412,0,3412,4
Rajasthan,Alwar,KHOOBRAJ NEERAJ,Bahujan Mukti Party,702,0,702,5
Rajasthan,Alwar,KHAIM CHAND,Bharatiya Yuva Shakti,1187,0,1187,6
Rajasthan,Alwar,DR. DASHRATH KUMAR HINUNIA,APoI,3611,1,3612,7
Rajasthan,Alwar,CHAUDHARY NASRUDEEN TANWAR,Socialist Party (India),662,0,662,8
Rajasthan,Alwar,NISHAR AHMED,Jai Maha Bharath Party,441,0,441,9
Rajasthan,Alwar,MANGURAM SAIN,ABCD(A),565,1,566,10
Rajasthan,Alwar,MURSHID AHMED,All India Trinamool Congress,2160,0,2160,11
Rajasthan,Alwar,VIRJANAND,Samajwadi Party,1843,2,1845,12
Rajasthan,Alwar,DR VIRENDRA VIDROHI,Aam Aadmi Party,8480,37,8517,13
Rajasthan,Alwar,SURESH SHARMA,JGP,2100,4,2104,14
Rajasthan,Alwar,KISHAN LAL,Independent,2572,0,2572,15
Rajasthan,Alwar,JAGDISH PRASAD BAIRWA,Independent,3390,0,3390,16
Rajasthan,Alwar,RAMESH PANVAL,Independent,1227,0,1227,17
Rajasthan,Alwar,HARIPRASAD,Independent,3579,1,3580,18
Rajasthan,Alwar,HARI SINGH SHARMA,Independent,3672,0,3672,19
Rajasthan,Alwar,None of the Above,NOTA,2503,9,2512,20
Rajasthan,BHARATPUR,BAHADUR SINGH KOLI,Bharatiya Janata Party,577863,1962,579825,1
Rajasthan,BHARATPUR,MAHENDAR KUMAR JATAV,Bahujan Samaj Party,22065,25,22090,2
Rajasthan,BHARATPUR,DR.SURESH JATAV,Indian National Congress,333619,738,334357,3
Rajasthan,BHARATPUR,AMAR CHAND POHIYA,Rajasthan Vikas Party,3969,0,3969,4
Rajasthan,BHARATPUR,GOPAL PAHARIA,Aam Aadmi Party,6990,23,7013,5
Rajasthan,BHARATPUR,LAKHAN SINGH,IPGP,959,1,960,6
Rajasthan,BHARATPUR,VIMLA UMAR,All India Trinamool Congress,1791,1,1792,7
Rajasthan,BHARATPUR,GHISU LAL,Independent,609,2,611,8
Rajasthan,BHARATPUR,PREM CHAND DHAMANI,Independent,835,0,835,9
Rajasthan,BHARATPUR,MADHURI PUSHKAR,Independent,1186,1,1187,10
Rajasthan,BHARATPUR,MAMRAJ,Independent,1787,0,1787,11
Rajasthan,BHARATPUR,SHEETAL JATAV,Independent,2071,0,2071,12
Rajasthan,BHARATPUR,None of the Above,NOTA,5928,7,5935,13
Rajasthan,KARAULI-DHOLPUR,G.R.BARUA,Bahujan Samaj Party,25147,3,25150,1
Rajasthan,KARAULI-DHOLPUR,MANOJ RAJORIYA,Bharatiya Janata Party,401921,486,402407,2
Rajasthan,KARAULI-DHOLPUR,LAKKHIRAM,Indian National Congress,374828,363,375191,3
Rajasthan,KARAULI-DHOLPUR,KAMAL SINGH,All India Trinamool Congress,7286,0,7286,4
Rajasthan,KARAULI-DHOLPUR,GHANSHYAM,Aam Aadmi Party,3726,0,3726,5
Rajasthan,KARAULI-DHOLPUR,DHANRAJ BAIRWA,Socialist Party (India),745,0,745,6
Rajasthan,KARAULI-DHOLPUR,PHOOLSINGH,JGP,951,0,951,7
Rajasthan,KARAULI-DHOLPUR,RAMESH,Bharatiya Yuva Shakti,1629,0,1629,8
Rajasthan,KARAULI-DHOLPUR,RAM SINGH,NPEP,9448,10,9458,9
Rajasthan,KARAULI-DHOLPUR,SHRELAL KHARE,Jai Maha Bharath Party,922,0,922,10
Rajasthan,KARAULI-DHOLPUR,ASHOK KUMAR,Independent,1383,2,1385,11
Rajasthan,KARAULI-DHOLPUR,KANCHAN BAI,Independent,3014,0,3014,12
Rajasthan,KARAULI-DHOLPUR,KISHOR KUMAR,Independent,3376,0,3376,13
Rajasthan,KARAULI-DHOLPUR,LAXMIKANT,Independent,4767,0,4767,14
Rajasthan,KARAULI-DHOLPUR,None of the Above,NOTA,5934,0,5934,15
Rajasthan,Dausa,CHANDU LAL MEENA (GEROTA),Bahujan Samaj Party,15299,4,15303,1
Rajasthan,Dausa,NAMONARAIN MEENA,Indian National Congress,181009,263,181272,2
Rajasthan,Dausa,HARISH CHANDRA MEENA ,Bharatiya Janata Party,314334,725,315059,3
Rajasthan,Dausa,DR. KIRODI LAL,NPEP,269032,623,269655,4
Rajasthan,Dausa,KHEMRAJ MEENA,Bharatiya Yuva Shakti,4297,0,4297,5
Rajasthan,Dausa,DHARMI GHUNAWAT,IPGP,1635,0,1635,6
Rajasthan,Dausa,RUKMANI MEENA JHAKHIWAL,Socialist Party (India),917,0,917,7
Rajasthan,Dausa,DR. SANJEET KUMAR DHANKA,Aam Aadmi Party,3196,6,3202,8
Rajasthan,Dausa,SURAJ BHAN DHANKA,Samajwadi Party,2357,0,2357,9
Rajasthan,Dausa,ANJALI BHADANA,Independent,3070,2,3072,10
Rajasthan,Dausa,ANJU DEVI DHANKA,Independent,16883,52,16935,11
Rajasthan,Dausa,DR. NASEEM GURJAR,Independent,5792,0,5792,12
Rajasthan,Dausa,BIMLA DEVI MEENA,Independent,20036,1,20037,13
Rajasthan,Dausa,SHIV PAL GURJAR,Independent,82493,56,82549,14
Rajasthan,Dausa,None of the Above,NOTA,8406,4,8410,15
Rajasthan,TONK-SAWAI MADHOPUR,MOHAMMED AZHARUDDIN,Indian National Congress,412836,195,413031,1
Rajasthan,TONK-SAWAI MADHOPUR,SUKHBIR SINGH JAUNAPURIA ,Bharatiya Janata Party,548146,391,548537,2
Rajasthan,TONK-SAWAI MADHOPUR,SURESH,Bahujan Samaj Party,10394,1,10395,3
Rajasthan,TONK-SAWAI MADHOPUR,JAGMOHAN MEENA,NPEP,14574,30,14604,4
Rajasthan,TONK-SAWAI MADHOPUR,DINESH,All India Trinamool Congress,2151,0,2151,5
Rajasthan,TONK-SAWAI MADHOPUR,DINESH SAINI,Jai Maha Bharath Party,2210,0,2210,6
Rajasthan,TONK-SAWAI MADHOPUR,BAJARANG LAL,RAHM,699,0,699,7
Rajasthan,TONK-SAWAI MADHOPUR,BHAR SINGH,Socialist Party (India),703,0,703,8
Rajasthan,TONK-SAWAI MADHOPUR,MUKESH,Aam Aadmi Party,2665,3,2668,9
Rajasthan,TONK-SAWAI MADHOPUR,RAMESH CHAND,Lok Dal,752,0,752,10
Rajasthan,TONK-SAWAI MADHOPUR,RAM HANS,NADP,869,0,869,11
Rajasthan,TONK-SAWAI MADHOPUR,VARIS ALI,AAP,2363,0,2363,12
Rajasthan,TONK-SAWAI MADHOPUR,KAMAL KUMAR DHOBI,Independent,1726,0,1726,13
Rajasthan,TONK-SAWAI MADHOPUR,KORI LAL,Independent,1925,0,1925,14
Rajasthan,TONK-SAWAI MADHOPUR,GOVIND PRASAD,Independent,3127,0,3127,15
Rajasthan,TONK-SAWAI MADHOPUR,CHANDAN LAL MEENA,Independent,6523,0,6523,16
Rajasthan,TONK-SAWAI MADHOPUR,BABULAL JANGID,Independent,7204,0,7204,17
Rajasthan,TONK-SAWAI MADHOPUR,MAKKHAN,Independent,10518,5,10523,18
Rajasthan,TONK-SAWAI MADHOPUR,RAM PARKASH,Independent,6186,0,6186,19
Rajasthan,TONK-SAWAI MADHOPUR,SAMPATTI BAI ALIAS SUNITA VERMA,Independent,1616,0,1616,20
Rajasthan,TONK-SAWAI MADHOPUR,SIYA RAM,Independent,1105,0,1105,21
Rajasthan,TONK-SAWAI MADHOPUR,HARI RAM,Independent,1048,0,1048,22
Rajasthan,TONK-SAWAI MADHOPUR,None of the Above,NOTA,3673,0,3673,23
Rajasthan,Ajmer,JAGDISH,Bahujan Samaj Party,7965,9,7974,1
Rajasthan,Ajmer,SACHIN PILOT,Indian National Congress,465072,819,465891,2
Rajasthan,Ajmer,SANWAR LAL JAT ,Bharatiya Janata Party,635990,1884,637874,3
Rajasthan,Ajmer,SANWAR LAL,Nationalist Congress Party,12132,17,12149,4
Rajasthan,Ajmer,MUKUL MISHRA,Akhil Bharat Hindu Mahasabha,1869,0,1869,5
Rajasthan,Ajmer,RAMLAL,AKBAP,1038,2,1040,6
Rajasthan,Ajmer,ANITA JAIN,Independent,910,0,910,7
Rajasthan,Ajmer,KRISHNA KUMAR DADHICH,Independent,1014,1,1015,8
Rajasthan,Ajmer,JAGDISH SINGH RAWAT,Independent,1374,0,1374,9
Rajasthan,Ajmer,NARAIN DAS SINDHI,Independent,3517,1,3518,10
Rajasthan,Ajmer,BHANWAR LAL SONI,Independent,4970,0,4970,11
Rajasthan,Ajmer,SURENDRA KUMAR JAIN,Independent,5184,0,5184,12
Rajasthan,Ajmer,None of the Above,NOTA,12534,12,12546,13
Rajasthan,Nagaur,ABDUL AZIZ,Bahujan Samaj Party,11235,4,11239,1
Rajasthan,Nagaur,C R CHOUDHARY,Bharatiya Janata Party,412745,2046,414791,2
Rajasthan,Nagaur,DR JYOTI MIRDHA,Indian National Congress,338748,825,339573,3
Rajasthan,Nagaur,AYUB KHAN,Samajwadi Party,7298,2,7300,4
Rajasthan,Nagaur,NEMICHAND,AVIRP,4368,4,4372,5
Rajasthan,Nagaur,BHANWAR SINGH RATHORE,All India Trinamool Congress,5767,9,5776,6
Rajasthan,Nagaur,HANUMANRAM,Aam Aadmi Party,3959,17,3976,7
Rajasthan,Nagaur,HARIRAM MEHRADA,BA S D,11347,5,11352,8
Rajasthan,Nagaur,CHHOTURAM,Independent,15226,8,15234,9
Rajasthan,Nagaur,MULARAM,Independent,4332,0,4332,10
Rajasthan,Nagaur,SUNIL,Independent,5250,1,5251,11
Rajasthan,Nagaur,HANUMAN BENIWAL,Independent,159519,461,159980,12
Rajasthan,Nagaur,HARIRAM,Independent,8658,0,8658,13
Rajasthan,Nagaur,None of the Above,NOTA,12176,9,12185,14
Rajasthan,Pali,P P CHAUDHARY,Bharatiya Janata Party,708015,3757,711772,1
Rajasthan,Pali,BHOJRAJ,Bahujan Samaj Party,16408,61,16469,2
Rajasthan,Pali,MUNNI DEVI GODARA,Indian National Congress,311506,1227,312733,3
Rajasthan,Pali,JAGDISH,Bahujan Mukti Party,7180,6,7186,4
Rajasthan,Pali,DEV KISHAN DEHIYA,MEDP,1257,7,1264,5
Rajasthan,Pali,MAHESH BHANDARI,Aam Aadmi Party,4976,55,5031,6
Rajasthan,Pali,SHOBHARAM MALI,Jai Maha Bharath Party,2822,3,2825,7
Rajasthan,Pali,UDARAM,Independent,2047,11,2058,8
Rajasthan,Pali,OM PRAKASH MALI,Independent,3302,4,3306,9
Rajasthan,Pali,KANHAIYALAL PAREEK,Independent,1884,6,1890,10
Rajasthan,Pali,DINESH MEV,Independent,2355,3,2358,11
Rajasthan,Pali,DR. RAMLAL MOHBARSHA,Independent,5784,10,5794,12
Rajasthan,Pali,SHER SINGH SAFA,Independent,5175,23,5198,13
Rajasthan,Pali,None of the Above,NOTA,17685,18,17703,14
Rajasthan,Jodhpur,GAJENDRASINGH SHEKHAWAT ,Bharatiya Janata Party,708060,5455,713515,1
Rajasthan,Jodhpur,GOPARAM MEGHWAL,Bahujan Samaj Party,13434,77,13511,2
Rajasthan,Jodhpur,CHANDRESH KUMARI,Indian National Congress,302031,1433,303464,3
Rajasthan,Jodhpur,DHANRAJ GEHLOT,Jai Maha Bharath Party,7099,5,7104,4
Rajasthan,Jodhpur,RAVI GARG,BNNP,1205,1,1206,5
Rajasthan,Jodhpur,VIGYAN MODI,Aam Aadmi Party,8461,91,8552,6
Rajasthan,Jodhpur,JAYDA,Independent,715,3,718,7
Rajasthan,Jodhpur,JETHARAM MEGHWAL,Independent,818,13,831,8
Rajasthan,Jodhpur,DUNGAR MAL PUNIYA,Independent,1034,7,1041,9
Rajasthan,Jodhpur,MEHMOODA BEGAM ABBASI,Independent,2627,4,2631,10
Rajasthan,Jodhpur,RAM DAYAL,Independent,2321,0,2321,11
Rajasthan,Jodhpur,RUGHA RAM CHOUDHARY ADVOCATE,Independent,4852,3,4855,12
Rajasthan,Jodhpur,SOHAN LAL GOYAL,Independent,3763,1,3764,13
Rajasthan,Jodhpur,None of the Above,NOTA,15063,22,15085,14
Rajasthan,Barmer,MALAM SINGH ,Bahujan Samaj Party,12878,5,12883,1
Rajasthan,Barmer,COL. SONA RAM,Bharatiya Janata Party,487437,1310,488747,2
Rajasthan,Barmer,HARISH CHAUDHARY,Indian National Congress,220364,517,220881,3
Rajasthan,Barmer,MANGILAL GAUR,Aam Aadmi Party,14898,8,14906,4
Rajasthan,Barmer,MAHANT ARJUNPURI,Independent,6379,1,6380,5
Rajasthan,Barmer,KHET SINGH RAJPUROHIT,Independent,12365,1,12366,6
Rajasthan,Barmer,JASWANT SINGH,Independent,400039,1247,401286,7
Rajasthan,Barmer,POPATRAM,Independent,7552,5,7557,8
Rajasthan,Barmer,BABULAL,Independent,6726,11,6737,9
Rajasthan,Barmer,MASTER BHAIRARAM MEGHWAL,Independent,13920,4,13924,10
Rajasthan,Barmer,RAMA RAM,Independent,17562,1,17563,11
Rajasthan,Barmer,None of the Above,NOTA,15884,5,15889,12
Rajasthan,Jalore,ANJANA UDAI LAL,Indian National Congress,199343,20,199363,1
Rajasthan,Jalore,OTARAM,Bahujan Samaj Party,29998,0,29998,2
Rajasthan,Jalore,DEVJI PATEL ,Bharatiya Janata Party,580304,204,580508,3
Rajasthan,Jalore,CHHAGANARAM / PRHALAD,Hindustan Janta Party,15811,0,15811,4
Rajasthan,Jalore,CHHAGANARAM / BHALARAM,Bahujan Mukti Party,3960,0,3960,5
Rajasthan,Jalore,RAN SINGH RAJPUROHIT,JGP,2731,0,2731,6
Rajasthan,Jalore,SUKH DEV,AAP,2017,0,2017,7
Rajasthan,Jalore,TARUN KUMAR,Independent,2596,0,2596,8
Rajasthan,Jalore,NARINGA RAM YADAV,Independent,3199,1,3200,9
Rajasthan,Jalore,NARAYAN LAL,Independent,9875,0,9875,10
Rajasthan,Jalore,S. BUTA SINGH,Independent,175228,116,175344,11
Rajasthan,Jalore,BHANWAR LAL WAGHELA,Independent,4817,0,4817,12
Rajasthan,Jalore,MANARA RAM,Independent,6146,0,6146,13
Rajasthan,Jalore,MAHENDRA K. CHOUDHARY,Independent,13008,0,13008,14
Rajasthan,Jalore,MOOLA RAM,Independent,10316,0,10316,15
Rajasthan,Jalore,SHANKAR LAL DARJI,Independent,16399,0,16399,16
Rajasthan,Jalore,None of the Above,NOTA,11180,3,11183,17
Rajasthan,Udaipur,ARJUNLAL MEENA ,Bharatiya Janata Party,657260,3113,660373,1
Rajasthan,Udaipur,MEGHRAJ TAWAR,Communist Party of India,33720,23,33743,2
Rajasthan,Udaipur,RAGHUVIR SINGH,Indian National Congress,422816,795,423611,3
Rajasthan,Udaipur,LAXMAN BHIL,Bahujan Samaj Party,20682,8,20690,4
Rajasthan,Udaipur,GOTAM LAL MEENA,Communist Party of India (Marxist-Lenninist) (Liberation),5437,5,5442,5
Rajasthan,Udaipur,PRABHU LAL MEENA,Bahujan Mukti Party,4520,9,4529,6
Rajasthan,Udaipur,LAXMILAL GAMETI,Socialist Party (India),6679,1,6680,7
Rajasthan,Udaipur,DR. VELARAM MEENA,Aam Aadmi Party,11390,59,11449,8
Rajasthan,Udaipur,None of the Above,NOTA,26662,23,26685,9
Rajasthan,Banswara,MANSHANKAR NINAMA ,Bharatiya Janata Party,575782,1651,577433,1
Rajasthan,Banswara,RESHAM MALVIYA,Indian National Congress,485096,421,485517,2
Rajasthan,Banswara,VIJAYPAL,Bahujan Samaj Party,27881,5,27886,3
Rajasthan,Banswara,BHANJI BHAI,Janata Dal (United),21759,1,21760,4
Rajasthan,Banswara,SOMA LAL KOTED,Bahujan Mukti Party,10476,65,10541,5
Rajasthan,Banswara,HARISH RAWAT,Aam Aadmi Party,13629,18,13647,6
Rajasthan,Banswara,None of the Above,NOTA,34389,15,34404,7
Rajasthan,Chittorgarh,GIRIJA VYAS,Indian National Congress,385733,646,386379,1
Rajasthan,Chittorgarh,CHANDRA PRAKASH JOSHI,Bharatiya Janata Party,701190,2046,703236,2
Rajasthan,Chittorgarh,RADHA DEVI,Communist Party of India,21592,1,21593,3
Rajasthan,Chittorgarh,SANJAY KUMAR,Bahujan Samaj Party,4466,1,4467,4
Rajasthan,Chittorgarh,DR. NARENDRA KUMAR GUPTA,Aam Aadmi Party,5917,22,5939,5
Rajasthan,Chittorgarh,PRABHU LAL GUJJAR,Jai Maha Bharath Party,1216,0,1216,6
Rajasthan,Chittorgarh,MANGI LAL SOLANKI,Bahujan Mukti Party,1289,2,1291,7
Rajasthan,Chittorgarh,VIJAYA RAY,Rajasthan Vikas Party,1238,2,1240,8
Rajasthan,Chittorgarh,SHANTI LAL TRIVEDI,Communist Party of India (Marxist-Lenninist) (Liberation),1557,7,1564,9
Rajasthan,Chittorgarh,GULAB CHAND SAHLOT,Independent,1688,4,1692,10
Rajasthan,Chittorgarh,BABU MEGHWAL,Independent,3063,6,3069,11
Rajasthan,Chittorgarh,BHANWAR LAL,Independent,3261,2,3263,12
Rajasthan,Chittorgarh,MOHAMMAD IMTIYAZ,Independent,4971,0,4971,13
Rajasthan,Chittorgarh,YASHWANT PURI,Independent,12675,0,12675,14
Rajasthan,Chittorgarh,None of the Above,NOTA,20020,14,20034,15
Rajasthan,Rajsamand,GOPAL SINGH SHEKHAWAT,Indian National Congress,248331,758,249089,1
Rajasthan,Rajsamand,NEERU RAM JAT,Bahujan Samaj Party,14541,38,14579,2
Rajasthan,Rajsamand,HARIOM SINGH RATHORE,Bharatiya Janata Party,641020,3774,644794,3
Rajasthan,Rajsamand,IDRISH MOHAMMAD,JGP,10398,9,10407,4
Rajasthan,Rajsamand,GULAM FARID,Samajwadi Party,2972,5,2977,5
Rajasthan,Rajsamand,PRADEEP SINGH BHATNAGAR,Aam Aadmi Party,4840,57,4897,6
Rajasthan,Rajsamand,LAXMAN,Jai Maha Bharath Party,1392,0,1392,7
Rajasthan,Rajsamand,KHIMARAM SALVI,Independent,2555,4,2559,8
Rajasthan,Rajsamand,BHANWAR LAL MALI,Independent,6410,8,6418,9
Rajasthan,Rajsamand,SANJAY CHOUDHARY,Independent,12336,143,12479,10
Rajasthan,Rajsamand,SURYA BHAWANI SINGH CHAWARA,Independent,10159,1,10160,11
Rajasthan,Rajsamand,HEERA KATHAT,Independent,5183,3,5186,12
Rajasthan,Rajsamand,None of the Above,NOTA,17154,28,17182,13
Rajasthan,Bhilwara,ASHOK CHANDNA,Indian National Congress,383403,650,384053,1
Rajasthan,Bhilwara,GOVIND KUMAR BAIRWA,Bahujan Samaj Party,15076,12,15088,2
Rajasthan,Bhilwara,SUBHASH BAHERIA,Bharatiya Janata Party,629117,1200,630317,3
Rajasthan,Bhilwara,CHANDRA PRAKASH GOCHER,Bharatiya Yuva Shakti,10338,6,10344,4
Rajasthan,Bhilwara,RADHY SHYAM VAISHNAV,BA S D,5682,2,5684,5
Rajasthan,Bhilwara,SUNIL AGIWAL,Aam Aadmi Party,5885,24,5909,6
Rajasthan,Bhilwara,ASLAM SHEKH ADVOCATE,Independent,1782,12,1794,7
Rajasthan,Bhilwara,RATAN LAL DHOBI,Independent,7103,7,7110,8
Rajasthan,Bhilwara,SHYAM LAL SALVI,Independent,5367,7,5374,9
Rajasthan,Bhilwara,SATYA PRAKASH SHARMA,Independent,11980,2,11982,10
Rajasthan,Bhilwara,SURENDAR SINGH RANAWAT,Independent,6734,3,6737,11
Rajasthan,Bhilwara,None of the Above,NOTA,19694,4,19698,12
Rajasthan,Kota,ASHOK KUMAR,Bahujan Samaj Party,10839,23,10862,1
Rajasthan,Kota,IJYARAJ SINGH,Indian National Congress,442492,1548,444040,2
Rajasthan,Kota,OM BIRLA ,Bharatiya Janata Party,641365,3457,644822,3
Rajasthan,Kota,AJMAT ALI,Bharatiya Yuva Shakti,7550,9,7559,4
Rajasthan,Kota,ASHOK KUMAR JAIN,Aam Aadmi Party,16888,93,16981,5
Rajasthan,Kota,MAHESH KUMAR RANIWAL,AVIRP,1008,2,1010,6
Rajasthan,Kota,RAJESH KUMAR,Jai Maha Bharath Party,1168,0,1168,7
Rajasthan,Kota,ASFAK ALI,Independent,1708,5,1713,8
Rajasthan,Kota,TEJPAL,Independent,1809,16,1825,9
Rajasthan,Kota,MAHENDRA KUMAR,Independent,2293,14,2307,10
Rajasthan,Kota,MOHAN LAL MAHAWAR,Independent,4820,2,4822,11
Rajasthan,Kota,SHYAM SUNDER SHARMA,Independent,5083,8,5091,12
Rajasthan,Kota,None of the Above,NOTA,12746,14,12760,13
Rajasthan,JHALAWAR-BARAN,CHANDRA SINGH,Bahujan Samaj Party,23587,0,23587,1
Rajasthan,JHALAWAR-BARAN,DUSHYANT SINGH,Bharatiya Janata Party,676022,80,676102,2
Rajasthan,JHALAWAR-BARAN,PRAMOD BHAYA,Indian National Congress,394514,42,394556,3
Rajasthan,JHALAWAR-BARAN,JAVED KHAN,Bharatiya Yuva Shakti,13617,0,13617,4
Rajasthan,JHALAWAR-BARAN,BALDAR,Independent,7836,0,7836,5
Rajasthan,JHALAWAR-BARAN,SULEMAN PUTA,Independent,11602,0,11602,6
Rajasthan,JHALAWAR-BARAN,None of the Above,NOTA,19064,0,19064,7
Sikkim,Sikkim,AKAR DHOJ LIMBU,Indian National Congress,6967,222,7189,1
Sikkim,Sikkim,NAR BAHADUR KHATIWADA,Bharatiya Janata Party,7188,91,7279,2
Sikkim,Sikkim,PREM DAS RAI,Sikkim Democratic Front,159704,3994,163698,3
Sikkim,Sikkim,KAUSHAL RAI,Aam Aadmi Party,2470,71,2541,4
Sikkim,Sikkim,NAKUL DAS RAI,All India Trinamool Congress,1908,64,1972,5
Sikkim,Sikkim,TEK NATH DHAKAL,Sikkim Krantikari Morcha,117071,4885,121956,6
Sikkim,Sikkim,None of the Above,NOTA,4259,73,4332,7
Tamil Nadu,Thiruvallur ,KANNAN A.S,Communist Party of India,13787,7,13794,1
Tamil Nadu,Thiruvallur ,SATHYAMURTHY.C,Bahujan Samaj Party,11137,0,11137,2
Tamil Nadu,Thiruvallur ,YUVARAJ.V,DMDK,204691,43,204734,3
Tamil Nadu,Thiruvallur ,VENUGOPAL.P.(DR),All India Anna Dravida Munnetra Kazhagam,628370,129,628499,4
Tamil Nadu,Thiruvallur ,JAYAKUMAR.M,Indian National Congress,43953,7,43960,5
Tamil Nadu,Thiruvallur ,SRINIVASAN.D,Samajwadi Party,2642,0,2642,6
Tamil Nadu,Thiruvallur ,BALAMURUGAN.B,Aam Aadmi Party,8259,1,8260,7
Tamil Nadu,Thiruvallur ,RAVIKUMAR.D,Viduthalai Chiruthaigal Katchi,304938,131,305069,8
Tamil Nadu,Thiruvallur ,CHANDRASEKARAN.M,Independent,1597,0,1597,9
Tamil Nadu,Thiruvallur ,SURESH KUMAR.S,Independent,1062,0,1062,10
Tamil Nadu,Thiruvallur ,DOSS.R,Independent,1596,0,1596,11
Tamil Nadu,Thiruvallur ,RAVIKUMAR.M,Independent,2965,1,2966,12
Tamil Nadu,Thiruvallur ,VETRISELVAM.K,Independent,2441,0,2441,13
Tamil Nadu,Thiruvallur ,VENUGOPAL.P,Independent,3084,1,3085,14
Tamil Nadu,Thiruvallur ,None of the Above,NOTA,23590,8,23598,15
Tamil Nadu,Chennai North,GIRIRAJAN .R,Dravida Munnetra Kazhagam,306687,313,307000,1
Tamil Nadu,Chennai North,SOUNDARAPANDIAN .M,DMDK,86952,37,86989,2
Tamil Nadu,Chennai North,BIJU CHACKO,Indian National Congress,24169,21,24190,3
Tamil Nadu,Chennai North,VASUKI .U,Communist Party of India  (Marxist),23725,26,23751,4
Tamil Nadu,Chennai North,VENKATESH BABU .T.G,All India Anna Dravida Munnetra Kazhagam,406552,152,406704,5
Tamil Nadu,Chennai North,JANARTHANAN .J,Bahujan Samaj Party,4959,1,4960,6
Tamil Nadu,Chennai North,SIVAKUMAR . V,SOCIALIST UNITY CENTRE OF INDIA (COMMUNIST),502,0,502,7
Tamil Nadu,Chennai North,NIJAM MOHAIDEEN .M,Social Democratic Party of India,14585,0,14585,8
Tamil Nadu,Chennai North,BABU MAILAN .A,Lok Seva Parishad,569,0,569,9
Tamil Nadu,Chennai North,PAULRAJ .T,MMKA,387,0,387,10
Tamil Nadu,Chennai North,RAMESH KANNAN .G,Republican Party of India,257,0,257,11
Tamil Nadu,Chennai North,VIJAYA KUMAR .K,Tamil Nadu Makkal Congress,1145,0,1145,12
Tamil Nadu,Chennai North,SRINIVASON .S,Aam Aadmi Party,6805,14,6819,13
Tamil Nadu,Chennai North,ANBAZHAGAN .G,Independent,208,0,208,14
Tamil Nadu,Chennai North,GIRIRAJ. D,Independent,414,0,414,15
Tamil Nadu,Chennai North,KESAVAN. L,Independent,1198,0,1198,16
Tamil Nadu,Chennai North,KOLANGI. M,Independent,1494,0,1494,17
Tamil Nadu,Chennai North,CHARAVANAN. M.P.,Independent,475,0,475,18
Tamil Nadu,Chennai North,SIVASHANMUGA PERUMAL. S,Independent,712,0,712,19
Tamil Nadu,Chennai North,SEETHA MALLAR. A,Independent,469,0,469,20
Tamil Nadu,Chennai North,SRINIVASAN. J,Independent,964,0,964,21
Tamil Nadu,Chennai North,SUNDAR. G,Independent,870,0,870,22
Tamil Nadu,Chennai North,SENTHIL KUMAR. K,Independent,472,0,472,23
Tamil Nadu,Chennai North,DEEPAK. C,Independent,475,0,475,24
Tamil Nadu,Chennai North,DURAI BABU. R,Independent,297,0,297,25
Tamil Nadu,Chennai North,DEVARAJ. G,Independent,386,0,386,26
Tamil Nadu,Chennai North,PAUL KANAGARAJ. R.C,Independent,1588,1,1589,27
Tamil Nadu,Chennai North,BALAJI. E,Independent,311,0,311,28
Tamil Nadu,Chennai North,PRABHAKARAN. K,Independent,457,0,457,29
Tamil Nadu,Chennai North,PONRAJ. P,Independent,208,0,208,30
Tamil Nadu,Chennai North,MAHENDRAN. K.P.P.,Independent,343,0,343,31
Tamil Nadu,Chennai North,MARIMUTHU. P,Independent,777,0,777,32
Tamil Nadu,Chennai North,MARIRAJ. T.R,Independent,559,0,559,33
Tamil Nadu,Chennai North,MOHAMED MAJASUDDIN,Independent,301,1,302,34
Tamil Nadu,Chennai North,YOGARAJ. S,Independent,206,0,206,35
Tamil Nadu,Chennai North,RAVIKUMAR. T,Independent,211,0,211,36
Tamil Nadu,Chennai North,RAVI PARIYANAR. D,Independent,600,0,600,37
Tamil Nadu,Chennai North,RAMASAMY. M.D.,Independent,234,0,234,38
Tamil Nadu,Chennai North,RAJ. N,Independent,216,0,216,39
Tamil Nadu,Chennai North,RAJA. B,Independent,337,0,337,40
Tamil Nadu,Chennai North,None of the Above,NOTA,17463,9,17472,41
Tamil Nadu,Chennai South,GANESAN  S,SOCIALIST UNITY CENTRE OF INDIA (COMMUNIST),1706,2,1708,1
Tamil Nadu,Chennai South,K.R.RAMASWAMY@TRAFFIC RAMASWAMY,Independent,1638,9,1647,2
Tamil Nadu,Chennai South,(KUPPAL)G.DEVADOSS,Independent,511,0,511,3
Tamil Nadu,Chennai South,A. JAIGANESH,Lok Seva Parishad,518,0,518,4
Tamil Nadu,Chennai South,LA.GANESAN,Bharatiya Janata Party,257970,292,258262,5
Tamil Nadu,Chennai South,S. BALU,Independent,259,0,259,6
Tamil Nadu,Chennai South,COLONEL KADAR BASHA,Independent,426,1,427,7
Tamil Nadu,Chennai South,DR. J. JAYAVARDHAN,All India Anna Dravida Munnetra Kazhagam,434229,311,434540,8
Tamil Nadu,Chennai South,T. DHANASEKAR,National Organisation Congress,325,3,328,9
Tamil Nadu,Chennai South,RAJINI NIVETHA,Independent,140,0,140,10
Tamil Nadu,Chennai South,R. RAVICHANDRAN,Independent,213,2,215,11
Tamil Nadu,Chennai South,V. BALAJI,Bahujan Samaj Party,1527,2,1529,12
Tamil Nadu,Chennai South,S.S.RADHAKRISHNAN,Independent,373,0,373,13
Tamil Nadu,Chennai South,THANGARAJ,Independent,187,1,188,14
Tamil Nadu,Chennai South,S. DEVADOSS,Independent,233,0,233,15
Tamil Nadu,Chennai South,S. SEETHALAKSHMI,Tamil Nadu Makkal Congress,1289,0,1289,16
Tamil Nadu,Chennai South,JAHIR HUSSAIN. M,Aam Aadmi Party,17172,36,17208,17
Tamil Nadu,Chennai South,S. PARTHIBAN,Independent,174,0,174,18
Tamil Nadu,Chennai South,LOGANATHAN,Independent,117,0,117,19
Tamil Nadu,Chennai South,A. IRUDAYADASS,Independent,975,1,976,20
Tamil Nadu,Chennai South,T.K.S.ELANGOVAN,Dravida Munnetra Kazhagam,298427,538,298965,21
Tamil Nadu,Chennai South,J.S. MAHALINGAM,Independent,267,0,267,22
Tamil Nadu,Chennai South,M. ARUMUGAM,Independent,219,2,221,23
Tamil Nadu,Chennai South,K. MANI,Janata Dal (United),273,1,274,24
Tamil Nadu,Chennai South,KANTHAVEL  D,Independent,865,0,865,25
Tamil Nadu,Chennai South,S. BALAMURALI,Independent,416,0,416,26
Tamil Nadu,Chennai South,S. RAJESHWARI,Independent,157,0,157,27
Tamil Nadu,Chennai South,S. VEERAMANI,Independent,105,0,105,28
Tamil Nadu,Chennai South,S.V. RAMANI,Indian National Congress,24239,37,24276,29
Tamil Nadu,Chennai South,B. KUMAR SRI SRI,Independent,232,0,232,30
Tamil Nadu,Chennai South,BHAVANI JANAKIRAM,Independent,244,0,244,31
Tamil Nadu,Chennai South,S. PRAGASAM,Independent,636,0,636,32
Tamil Nadu,Chennai South,T. PONNUSAMY,Independent,533,0,533,33
Tamil Nadu,Chennai South,A. MAGESH,Independent,121,0,121,34
Tamil Nadu,Chennai South,PON. SIVA KUMAR,Independent,271,0,271,35
Tamil Nadu,Chennai South,S. CHARUMATHI,Independent,256,1,257,36
Tamil Nadu,Chennai South,S. SESU RAJ,Independent,203,0,203,37
Tamil Nadu,Chennai South,K. SHANKAR,Independent,498,0,498,38
Tamil Nadu,Chennai South,JOSEPH GUNASEKAR,Independent,253,0,253,39
Tamil Nadu,Chennai South,R. KANDASAMY@BABU,Ambedkar Peoples Movement,371,1,372,40
Tamil Nadu,Chennai South,M. JAYARAMAN,Independent,191,1,192,41
Tamil Nadu,Chennai South,T.K. RAMAJAYAM,Independent,1180,0,1180,42
Tamil Nadu,Chennai South,None of the Above,NOTA,20200,29,20229,43
Tamil Nadu,Chennai central,S.D. KRISHNAKUMAR,Republican Party of India (A),1527,1,1528,1
Tamil Nadu,Chennai central,S.R. VIJAYAKUMAR,All India Anna Dravida Munnetra Kazhagam,333103,193,333296,2
Tamil Nadu,Chennai central,J. PRABHAKAR,Aam Aadmi Party,19515,38,19553,3
Tamil Nadu,Chennai central,B. AMBETH VENKATESH,Independent,387,3,390,4
Tamil Nadu,Chennai central,J. CONSTANDINE RAVINDRAN,DMDK,114759,39,114798,5
Tamil Nadu,Chennai central,MURALIKRISHNAN (A) SAMARAN,Bahujan Samaj Party,2527,4,2531,6
Tamil Nadu,Chennai central,D. BABU,Independent,261,0,261,7
Tamil Nadu,Chennai central,C.D. MEYYAPPAN,Indian National Congress,25963,18,25981,8
Tamil Nadu,Chennai central,DAYANIDHI MARAN,Dravida Munnetra Kazhagam,286980,475,287455,9
Tamil Nadu,Chennai central,M. PRABAKARAN,Independent,329,7,336,10
Tamil Nadu,Chennai central,M. MURUGAN,Independent,696,1,697,11
Tamil Nadu,Chennai central,P. MANIMARAN,Independent,391,0,391,12
Tamil Nadu,Chennai central,K.RAVEENDRAN,Independent,369,0,369,13
Tamil Nadu,Chennai central,D. RAMESH,Independent,259,0,259,14
Tamil Nadu,Chennai central,M. MOHAMED RASIK,Independent,2015,4,2019,15
Tamil Nadu,Chennai central,V. CHANDRAMOHAN,Independent,322,2,324,16
Tamil Nadu,Chennai central,T. RAVIKUMAR,Independent,971,2,973,17
Tamil Nadu,Chennai central,AUDITOR GOPINARAYANAN,MMKA,805,0,805,18
Tamil Nadu,Chennai central,P. AHILA,Independent,578,1,579,19
Tamil Nadu,Chennai central,ARUNDHATHI JAIGANESH (A) S.JAIGANESH,Independent,389,1,390,20
Tamil Nadu,Chennai central,None of the Above,NOTA,21933,26,21959,21
Tamil Nadu,Sriperumbudur,ARUL ANBARASU,Indian National Congress,39008,7,39015,1
Tamil Nadu,Sriperumbudur,"RAMACHANDRAN, K.N. THIRU",All India Anna Dravida Munnetra Kazhagam,545643,177,545820,2
Tamil Nadu,Sriperumbudur,"MOHAMED ABBAS, S. THIRU",Bahujan Samaj Party,4975,2,4977,3
Tamil Nadu,Sriperumbudur,"JAGATHRAKSHAKAN, S. THIRU",Dravida Munnetra Kazhagam,442906,268,443174,4
Tamil Nadu,Sriperumbudur,"BHARATHI, K. THIRU",Communist Party of India (Marxist-Lenninist) (Liberation),4739,4,4743,5
Tamil Nadu,Sriperumbudur,PULAVAR. E.SU. MANI. THIRU,National Organisation Congress,870,0,870,6
Tamil Nadu,Sriperumbudur,"MASILAMANI, R. (DR).",Marumalarchi Dravida Munnetra Kazhagam,187049,45,187094,7
Tamil Nadu,Sriperumbudur,"VASIGARAN, S.A.N. THIRU",Aam Aadmi Party,18953,10,18963,8
Tamil Nadu,Sriperumbudur,"SRIDHAR, C. THIRU",Ulzaipali Makkal Katchy,497,0,497,9
Tamil Nadu,Sriperumbudur,"AYODHI, L.( DR).",Independent,699,0,699,10
Tamil Nadu,Sriperumbudur,"SHANMUGAM, K. THIRU",Independent,291,0,291,11
Tamil Nadu,Sriperumbudur,"SHANMUGAM, G. THIRU",Independent,372,0,372,12
Tamil Nadu,Sriperumbudur,SAMPATH. K. THIRU,Independent,1301,0,1301,13
Tamil Nadu,Sriperumbudur,"PALANI, A. THIRU",Independent,781,0,781,14
Tamil Nadu,Sriperumbudur,BHARATHIDASAN R. THIRU.,Independent,811,0,811,15
Tamil Nadu,Sriperumbudur,"PUGAZHENDI, A. THIRU",Independent,1726,0,1726,16
Tamil Nadu,Sriperumbudur,"MADHAVARAJ, K.V. THIRU.",Independent,1165,0,1165,17
Tamil Nadu,Sriperumbudur,"RAMESH, THIRU",Independent,2782,0,2782,18
Tamil Nadu,Sriperumbudur,"RAMACHANDIRAN, K. THIRU",Independent,791,0,791,19
Tamil Nadu,Sriperumbudur,"RAJAGOPAL MALLAR, P. THIRU",Independent,2622,0,2622,20
Tamil Nadu,Sriperumbudur,"SRIDHAR,M.THIRU",Independent,477,0,477,21
Tamil Nadu,Sriperumbudur,None of the Above,NOTA,27669,7,27676,22
Tamil Nadu,Kancheepuram ,SATHIYARAJ  J.S,Bahujan Samaj Party,6794,13,6807,1
Tamil Nadu,Kancheepuram ,SELVAM  G,Dravida Munnetra Kazhagam,351851,678,352529,2
Tamil Nadu,Kancheepuram ,MARAGATHAM  K,All India Anna Dravida Munnetra Kazhagam,499010,385,499395,3
Tamil Nadu,Kancheepuram ,VISWANATHAN  P,Indian National Congress,33266,47,33313,4
Tamil Nadu,Kancheepuram ,SATHYA  C.E.,Marumalarchi Dravida Munnetra Kazhagam,206880,200,207080,5
Tamil Nadu,Kancheepuram ,ULAGANATHAN  .A,Independent,1479,0,1479,6
Tamil Nadu,Kancheepuram ,"SATHIYANATHAN, N.",Independent,1088,1,1089,7
Tamil Nadu,Kancheepuram ,SRINIVASAN C.,Independent,1090,0,1090,8
Tamil Nadu,Kancheepuram ,PARGUNAN  A.,Independent,1367,1,1368,9
Tamil Nadu,Kancheepuram ,"BALAMURUGAN, R",Independent,2894,1,2895,10
Tamil Nadu,Kancheepuram ,MARAGATHAM M,Independent,3616,2,3618,11
Tamil Nadu,Kancheepuram ,None of the Above,NOTA,17721,15,17736,12
Tamil Nadu,Arakkonam,"HARI, G.",All India Anna Dravida Munnetra Kazhagam,492667,867,493534,1
Tamil Nadu,Arakkonam,"ELANGO, N.R",Dravida Munnetra Kazhagam,252073,695,252768,2
Tamil Nadu,Arakkonam,"DASS, D.",Bahujan Samaj Party,7348,6,7354,3
Tamil Nadu,Arakkonam,"RAJESH, R",Indian National Congress,56300,37,56337,4
Tamil Nadu,Arakkonam,"RAJESH, S.",Aam Aadmi Party,4008,13,4021,5
Tamil Nadu,Arakkonam,"VELU, R.",Pattali Makkal Katchi,233390,372,233762,6
Tamil Nadu,Arakkonam,"HARI, S.",Independent,1458,0,1458,7
Tamil Nadu,Arakkonam,"HARI, S.",Independent,599,0,599,8
Tamil Nadu,Arakkonam,"HARIKRISHNAN, P.",Independent,541,0,541,9
Tamil Nadu,Arakkonam,"ARUN, N.",Independent,610,0,610,10
Tamil Nadu,Arakkonam,"RAVI, V.",Independent,2198,0,2198,11
Tamil Nadu,Arakkonam,"ELANGO, D.",Independent,517,0,517,12
Tamil Nadu,Arakkonam,"ELANGO, N.",Independent,918,0,918,13
Tamil Nadu,Arakkonam,"ELANGOVAN, A.",Independent,804,0,804,14
Tamil Nadu,Arakkonam,"ELANGOVAN, D.",Independent,1553,3,1556,15
Tamil Nadu,Arakkonam,PANCHU.UDAYAKUMAR,Independent,6024,1,6025,16
Tamil Nadu,Arakkonam,"GAJENDRAN, S.",Independent,6570,0,6570,17
Tamil Nadu,Arakkonam,"GOPINATHAN, G.",Independent,1955,0,1955,18
Tamil Nadu,Arakkonam,"SADHU MUTHU KRISTNAN ERAJANDRAN, T.M.S.",Independent,484,0,484,19
Tamil Nadu,Arakkonam,"SHETTU, S.",Independent,570,0,570,20
Tamil Nadu,Arakkonam,"RAVI, N.D.",Independent,470,1,471,21
Tamil Nadu,Arakkonam,"VADIVEL, A.",Independent,1023,0,1023,22
Tamil Nadu,Arakkonam,"VISWANATHAN, P.",Independent,1434,0,1434,23
Tamil Nadu,Arakkonam,"VELU, R.",Independent,747,0,747,24
Tamil Nadu,Arakkonam,"VELU, D.",Independent,920,0,920,25
Tamil Nadu,Arakkonam,"VELU, V.",Independent,783,0,783,26
Tamil Nadu,Arakkonam,"SRIDHAR, R.S",Independent,723,0,723,27
Tamil Nadu,Arakkonam,None of the Above,NOTA,10355,15,10370,28
Tamil Nadu,Vellore,"SHANMUGAM, A.C.",Bharatiya Janata Party,324058,268,324326,1
Tamil Nadu,Vellore,"SENGUTTUVAN, B.",All India Anna Dravida Munnetra Kazhagam,383583,136,383719,2
Tamil Nadu,Vellore,"VIJAY ELANCHEZIAN, J.",Indian National Congress,21641,9,21650,3
Tamil Nadu,Vellore,JAYAPRAKASH,Bahujan Samaj Party,2791,0,2791,4
Tamil Nadu,Vellore,"ABDUL RAHMAN, M.",Indian Union Muslim League,205239,657,205896,5
Tamil Nadu,Vellore,"IMDAD SHARIFF, A.",Aam Aadmi Party,3737,5,3742,6
Tamil Nadu,Vellore,"GANGADHARAN, K.",Tamil Nadu Makkal Congress,429,1,430,7
Tamil Nadu,Vellore,"NANDHA KUMAR, V.",Samajwadi Party,745,0,745,8
Tamil Nadu,Vellore,"GEORGE, V.A.",BDBRAJP,490,1,491,9
Tamil Nadu,Vellore,"SHAREEF BASHA, H.",Samata Party,496,0,496,10
Tamil Nadu,Vellore,"ABDUL RAHMAN, N.",Independent,581,0,581,11
Tamil Nadu,Vellore,"ABDUL RAHMAN, B.",Independent,1052,0,1052,12
Tamil Nadu,Vellore,"ESWARAN, R.",Independent,790,0,790,13
Tamil Nadu,Vellore,"GANGADARAN, K.",Independent,991,0,991,14
Tamil Nadu,Vellore,"KESAVAN, M.",Independent,1708,0,1708,15
Tamil Nadu,Vellore,"GOPU, C.",Independent,6056,0,6056,16
Tamil Nadu,Vellore,"GOVINDAN, C.",Independent,4169,0,4169,17
Tamil Nadu,Vellore,"SIVAPRAKASAM, R.S.",Independent,3603,0,3603,18
Tamil Nadu,Vellore,"SUGUMAR, K.",Independent,828,0,828,19
Tamil Nadu,Vellore,"DHANDAPANI, M.",Independent,558,0,558,20
Tamil Nadu,Vellore,"THIRUPATHY, T.",Independent,1293,0,1293,21
Tamil Nadu,Vellore,"MANIMARAN, M.",Independent,430,0,430,22
Tamil Nadu,Vellore,"LALITHA, K.",Independent,561,0,561,23
Tamil Nadu,Vellore,"VENKATESAN, R.",Independent,764,0,764,24
Tamil Nadu,Vellore,None of the Above,NOTA,7094,6,7100,25
Tamil Nadu,Krishnagiri,ASHOK KUMAR.K,All India Anna Dravida Munnetra Kazhagam,480441,50,480491,1
Tamil Nadu,Krishnagiri,CHANBASHA.M,Bahujan Samaj Party,8617,1,8618,2
Tamil Nadu,Krishnagiri,CHINNA PILLAPPA.P,Dravida Munnetra Kazhagam,273876,24,273900,3
Tamil Nadu,Krishnagiri,CHELLAKUMAR. DR. A,Indian National Congress,38877,8,38885,4
Tamil Nadu,Krishnagiri,GOWDA.NSM,Janata Dal (Secular),3032,1,3033,5
Tamil Nadu,Krishnagiri,SUNDARAM.S,United Communist Party of India,3665,0,3665,6
Tamil Nadu,Krishnagiri,MANI.G.K,Pattali Makkal Katchi,224920,43,224963,7
Tamil Nadu,Krishnagiri,MUNIRAJ.K,Ulzaipali Makkal Katchy,2135,0,2135,8
Tamil Nadu,Krishnagiri,ASHOK KUMAR.A,Independent,3875,0,3875,9
Tamil Nadu,Krishnagiri,GANDHI.TVS,Independent,1519,0,1519,10
Tamil Nadu,Krishnagiri,SARAVANAN.V,Independent,2737,0,2737,11
Tamil Nadu,Krishnagiri,SOUNDARAJAN.M,Independent,1743,1,1744,12
Tamil Nadu,Krishnagiri,PATTABIRAMA.C,Independent,2015,0,2015,13
Tamil Nadu,Krishnagiri,VIRGINIYA BENATIN FRANCILES,Independent,2530,0,2530,14
Tamil Nadu,Krishnagiri,VINOTHKUMAR.P,Independent,2261,0,2261,15
Tamil Nadu,Krishnagiri,None of the Above,NOTA,16014,6,16020,16
Tamil Nadu,Dharmapuri,THAMARAISELVAN.R,Dravida Munnetra Kazhagam,180110,187,180297,1
Tamil Nadu,Dharmapuri,MOHAN.P.S,All India Anna Dravida Munnetra Kazhagam,390718,330,391048,2
Tamil Nadu,Dharmapuri,RAJINIKANTH.S,Bahujan Samaj Party,8179,1,8180,3
Tamil Nadu,Dharmapuri,RAMA SUGANTHAN,Indian National Congress,15450,5,15455,4
Tamil Nadu,Dharmapuri,ANBUMANI RAMADOSS,Pattali Makkal Katchi,467775,419,468194,5
Tamil Nadu,Dharmapuri,SAVITHIRI.K,Ulzaipali Makkal Katchy,3164,0,3164,6
Tamil Nadu,Dharmapuri,ANGURAJ.P,Independent,3905,0,3905,7
Tamil Nadu,Dharmapuri,ARIVAZHAGAN.P,Independent,2802,0,2802,8
Tamil Nadu,Dharmapuri,ARIVUDAINAMBI.M,Independent,1401,2,1403,9
Tamil Nadu,Dharmapuri,ANBUMANI.G,Independent,1366,4,1370,10
Tamil Nadu,Dharmapuri,ANANDKUMAR.K,Independent,1978,0,1978,11
Tamil Nadu,Dharmapuri,KUMARAN.V,Independent,2413,0,2413,12
Tamil Nadu,Dharmapuri,SAMBATH.M,Independent,1310,0,1310,13
Tamil Nadu,Dharmapuri,NATARAJAN.R,Independent,2199,0,2199,14
Tamil Nadu,Dharmapuri,PADMARAJAN.K.DR,Independent,4934,0,4934,15
Tamil Nadu,Dharmapuri,None of the Above,NOTA,12681,12,12693,16
Tamil Nadu,Tiruvannamalai,ANNADURAI C N,Dravida Munnetra Kazhagam,330266,1879,332145,1
Tamil Nadu,Tiruvannamalai,SUBRAMANIYAN A,Indian National Congress,17824,30,17854,2
Tamil Nadu,Tiruvannamalai,BASKARAN  M R,Bahujan Samaj Party,4326,2,4328,3
Tamil Nadu,Tiruvannamalai,VANAROJA R,All India Anna Dravida Munnetra Kazhagam,499337,1414,500751,4
Tamil Nadu,Tiruvannamalai,ARUMUGAM C,Samajwadi Party,6275,3,6278,5
Tamil Nadu,Tiruvannamalai,EDIROLI MANIAN G,Pattali Makkal Katchi,157391,563,157954,6
Tamil Nadu,Tiruvannamalai,MANIKKAVEL M R,Janata Dal (Secular),1549,6,1555,7
Tamil Nadu,Tiruvannamalai,RAVINDRAN T,Tamil Nadu Makkal Congress,1998,1,1999,8
Tamil Nadu,Tiruvannamalai,ANNADURAI A,Independent,864,1,865,9
Tamil Nadu,Tiruvannamalai,ANNADURAI B,Independent,1693,0,1693,10
Tamil Nadu,Tiruvannamalai,ARUNACHALAM P,Independent,736,0,736,11
Tamil Nadu,Tiruvannamalai,ARULJOTHI A,Independent,904,0,904,12
Tamil Nadu,Tiruvannamalai,ANBALAGAN D,Independent,1686,0,1686,13
Tamil Nadu,Tiruvannamalai,ARUMUGAM R,Independent,971,2,973,14
Tamil Nadu,Tiruvannamalai,KAMARAJ M,Independent,1369,0,1369,15
Tamil Nadu,Tiruvannamalai,KOTHANDAPANI B,Independent,4688,0,4688,16
Tamil Nadu,Tiruvannamalai,SENTHIL S,Independent,3867,0,3867,17
Tamil Nadu,Tiruvannamalai,PRABAKARAN L,Independent,679,0,679,18
Tamil Nadu,Tiruvannamalai,MURUGAN P,Independent,988,3,991,19
Tamil Nadu,Tiruvannamalai,MURUGESAN K,Independent,10702,6,10708,20
Tamil Nadu,Tiruvannamalai,RAMESH P,Independent,2444,1,2445,21
Tamil Nadu,Tiruvannamalai,LOGANATHAN P,Independent,1729,0,1729,22
Tamil Nadu,Tiruvannamalai,VELMURUGAN A,Independent,724,0,724,23
Tamil Nadu,Tiruvannamalai,VAITHIYANATHAN S,Independent,931,0,931,24
Tamil Nadu,Tiruvannamalai,None of the Above,NOTA,9563,32,9595,25
Tamil Nadu,Arani,V.ELUMALAI,All India Anna Dravida Munnetra Kazhagam,501662,1059,502721,1
Tamil Nadu,Arani,A.GANESAN,Bahujan Samaj Party,5568,5,5573,2
Tamil Nadu,Arani,SIVANANDAM.R,Dravida Munnetra Kazhagam,257516,1361,258877,3
Tamil Nadu,Arani,M.K.VISHNU PRASAD,Indian National Congress,27679,38,27717,4
Tamil Nadu,Arani,V.ANNA VENKATESH,ADSMK,2369,3,2372,5
Tamil Nadu,Arani,A.K.MOORTHY,Pattali Makkal Katchi,252310,1022,253332,6
Tamil Nadu,Arani,K.ELUMALAI,Independent,1243,0,1243,7
Tamil Nadu,Arani,S.ELUMALAI,Independent,513,0,513,8
Tamil Nadu,Arani,R.SARASWATHI,Independent,666,2,668,9
Tamil Nadu,Arani,H.SENTHILKUMAR,Independent,798,0,798,10
Tamil Nadu,Arani,S.SENTHILNATHAN,Independent,1742,4,1746,11
Tamil Nadu,Arani,M.DURAIRAJ,Independent,910,0,910,12
Tamil Nadu,Arani,A.MAHADEVAN,Independent,1307,2,1309,13
Tamil Nadu,Arani,S.MANIKANDAN,Independent,1952,0,1952,14
Tamil Nadu,Arani,M.MUNUSAMY,Independent,2596,2,2598,15
Tamil Nadu,Arani,K.MOORTHY,Independent,10258,5,10263,16
Tamil Nadu,Arani,V.MOORTHY,Independent,8059,0,8059,17
Tamil Nadu,Arani,S.RAMAMOORTHY,Independent,1760,0,1760,18
Tamil Nadu,Arani,P.LOGANATHAN,Independent,4329,2,4331,19
Tamil Nadu,Arani,None of the Above,NOTA,9265,39,9304,20
Tamil Nadu,Viluppuram,ANANDAN G,Communist Party of India  (Marxist),17374,34,17408,1
Tamil Nadu,Viluppuram,UMASANKAR K,DMDK,209162,501,209663,2
Tamil Nadu,Viluppuram,KARUNSIRUTHAI KALIYAMURTHI G,Bahujan Samaj Party,2677,6,2683,3
Tamil Nadu,Viluppuram,MUTHAIYAN K DR,Dravida Munnetra Kazhagam,287834,1503,289337,4
Tamil Nadu,Viluppuram,RANI K,Indian National Congress,21441,20,21461,5
Tamil Nadu,Viluppuram,RAJENDRAN S,All India Anna Dravida Munnetra Kazhagam,481296,1408,482704,6
Tamil Nadu,Viluppuram,VENKATESAN M,Communist Party of India (Marxist-Lenninist) (Liberation),3906,0,3906,7
Tamil Nadu,Viluppuram,ARASAN K,Independent,811,0,811,8
Tamil Nadu,Viluppuram,ARUMUGAM R,Independent,693,0,693,9
Tamil Nadu,Viluppuram,UMASANKAR M,Independent,1212,0,1212,10
Tamil Nadu,Viluppuram,ELUMALAI D,Independent,2337,0,2337,11
Tamil Nadu,Viluppuram,KADRVEL M,Independent,3430,0,3430,12
Tamil Nadu,Viluppuram,SRINIVASAN K,Independent,2294,0,2294,13
Tamil Nadu,Viluppuram,DESINGU K,Independent,1607,0,1607,14
Tamil Nadu,Viluppuram,DEVI S,Independent,3443,0,3443,15
Tamil Nadu,Viluppuram,MUTHAIYAN N,Independent,4780,0,4780,16
Tamil Nadu,Viluppuram,MUTHIYAN,Independent,1774,0,1774,17
Tamil Nadu,Viluppuram,RAMESH A,Independent,2663,0,2663,18
Tamil Nadu,Viluppuram,RAJAMANICKAM K,Independent,1197,0,1197,19
Tamil Nadu,Viluppuram,VENKATESAN S,Independent,2798,0,2798,20
Tamil Nadu,Viluppuram,None of the Above,NOTA,11429,11,11440,21
Tamil Nadu,Kallakurichi,ESWARAN. V. P,DMDK,164019,164,164183,1
Tamil Nadu,Kallakurichi,KAMARAJ. K,All India Anna Dravida Munnetra Kazhagam,531365,2018,533383,2
Tamil Nadu,Kallakurichi,SAKTHIVEL.S,Bahujan Samaj Party,5929,0,5929,3
Tamil Nadu,Kallakurichi,DEVADASS. R,Indian National Congress,39640,37,39677,4
Tamil Nadu,Kallakurichi,MANIMARAN. R,Dravida Munnetra Kazhagam,308537,1339,309876,5
Tamil Nadu,Kallakurichi,PERUMAL. A. K.,Jharkhand Mukti Morcha (Ulgulan),3511,1,3512,6
Tamil Nadu,Kallakurichi,MOHAMMED YASIN. K,Aam Aadmi Party,2905,5,2910,7
Tamil Nadu,Kallakurichi,RAMACHANDIRAN. T,Independent,1013,0,1013,8
Tamil Nadu,Kallakurichi,KAMARAJ. R,Independent,1334,0,1334,9
Tamil Nadu,Kallakurichi,GOVINDASAMY.A,Independent,1015,0,1015,10
Tamil Nadu,Kallakurichi,SEKAR. K,Independent,962,0,962,11
Tamil Nadu,Kallakurichi,NARAYANSAMY. P,Independent,1684,0,1684,12
Tamil Nadu,Kallakurichi,PANDIAN. R,Independent,1221,0,1221,13
Tamil Nadu,Kallakurichi,BOJAN. G,Independent,2255,0,2255,14
Tamil Nadu,Kallakurichi,MANNAN. M. P,Independent,6186,0,6186,15
Tamil Nadu,Kallakurichi,MADAIYAN. S,Independent,7314,0,7314,16
Tamil Nadu,Kallakurichi,LAKSHMANAN. S,Independent,3261,0,3261,17
Tamil Nadu,Kallakurichi,VARADAN. M,Independent,5054,0,5054,18
Tamil Nadu,Kallakurichi,VENNILA.  K,Independent,1097,0,1097,19
Tamil Nadu,Kallakurichi,VELLIYAN. K,Independent,946,0,946,20
Tamil Nadu,Kallakurichi,VETRIVEL. K,Independent,2029,0,2029,21
Tamil Nadu,Kallakurichi,SHAJAHAN. A,Independent,1499,0,1499,22
Tamil Nadu,Kallakurichi,None of the Above,NOTA,10886,15,10901,23
Tamil Nadu,Salem,UMARANI. S,Dravida Munnetra Kazhagam,288552,384,288936,1
Tamil Nadu,Salem,SUDHISH L K,DMDK,201086,179,201265,2
Tamil Nadu,Salem,PANNERSELVAM.V,All India Anna Dravida Munnetra Kazhagam,556061,485,556546,3
Tamil Nadu,Salem,RANGARAJAN MOHAN KUMARAMANGALAM,Indian National Congress,46450,27,46477,4
Tamil Nadu,Salem,VINAYAGAMOORTHI T,Bahujan Samaj Party,1617,2,1619,5
Tamil Nadu,Salem,SHANMUGAM G,MMKA,1623,0,1623,6
Tamil Nadu,Salem,SATHEESH KUMAR E,Aam Aadmi Party,5180,18,5198,7
Tamil Nadu,Salem,MASS GANESH A,TTNC,474,0,474,8
Tamil Nadu,Salem,VENKATESAN R,Republican Party of India (A),623,0,623,9
Tamil Nadu,Salem,M AHAMED SHAHJAHAN,Independent,528,1,529,10
Tamil Nadu,Salem,ABDUL WAHID I,Independent,526,0,526,11
Tamil Nadu,Salem,ARUMUGAM M,Independent,730,1,731,12
Tamil Nadu,Salem,UMARANI S,Independent,1232,0,1232,13
Tamil Nadu,Salem,KANDASAMY R,Independent,2550,0,2550,14
Tamil Nadu,Salem,KUPPAYEE R,Independent,1701,0,1701,15
Tamil Nadu,Salem,GOVINDARAJU K,Independent,3260,1,3261,16
Tamil Nadu,Salem,SAKTHIVEL S,Independent,2581,0,2581,17
Tamil Nadu,Salem,CHINNUSAMY N,Independent,5374,0,5374,18
Tamil Nadu,Salem,SENTHIL KUMAR M,Independent,2903,0,2903,19
Tamil Nadu,Salem,THIAGARAJAN K,Independent,777,0,777,20
Tamil Nadu,Salem,NANDAKUMAR G,Independent,357,0,357,21
Tamil Nadu,Salem,PANNEERSELVAM N,Independent,574,0,574,22
Tamil Nadu,Salem,PRAKASAM R,Independent,484,0,484,23
Tamil Nadu,Salem,RAJA A,Independent,2203,0,2203,24
Tamil Nadu,Salem,RAJAKANNU A,Independent,1151,0,1151,25
Tamil Nadu,Salem,None of the Above,NOTA,20577,24,20601,26
Tamil Nadu,Namakkal,GANDHISELVAN.S,Dravida Munnetra Kazhagam,268411,487,268898,1
Tamil Nadu,Namakkal,SUNDARAM P.R,All India Anna Dravida Munnetra Kazhagam,562899,373,563272,2
Tamil Nadu,Namakkal,SUBRAMANIYAN G.R,Indian National Congress,19796,4,19800,3
Tamil Nadu,Namakkal,SELVARAJ.R,Bahujan Samaj Party,1788,0,1788,4
Tamil Nadu,Namakkal,VEL S.K,DMDK,146768,114,146882,5
Tamil Nadu,Namakkal,KALAIVANAN.M,Janata Dal (Secular),1710,1,1711,6
Tamil Nadu,Namakkal,CHELLAKUMARASAMY.T.S(DR),Aam Aadmi Party,4341,7,4348,7
Tamil Nadu,Namakkal,GNANAPANDITHAN.P,Republican Party of India (A),700,0,700,8
Tamil Nadu,Namakkal,VADIVEL.R,Ulzaipali Makkal Katchy,736,1,737,9
Tamil Nadu,Namakkal,VELUSAMY.S,Tamil Nadu Makkal Congress,4826,1,4827,10
Tamil Nadu,Namakkal,RAMASAMY.P,Independent,717,0,717,11
Tamil Nadu,Namakkal,RAMAJEYAM.G,Independent,915,0,915,12
Tamil Nadu,Namakkal,KRISHNAN.M,Independent,2077,2,2079,13
Tamil Nadu,Namakkal,GUNASEKARAN.S,Independent,1599,1,1600,14
Tamil Nadu,Namakkal,SAKTHIVEL.S.P,Independent,3916,4,3920,15
Tamil Nadu,Namakkal,SIVAJI.S.M,Independent,4806,2,4808,16
Tamil Nadu,Namakkal,SUBRAMANI.S,Independent,3070,0,3070,17
Tamil Nadu,Namakkal,SELVAM.G,Independent,3362,0,3362,18
Tamil Nadu,Namakkal,SELVARAJ.S,Independent,835,0,835,19
Tamil Nadu,Namakkal,DHARMALINGAM.M,Independent,473,0,473,20
Tamil Nadu,Namakkal,NATARAJAN.M,Independent,1182,0,1182,21
Tamil Nadu,Namakkal,PANNEERSELVAM.S,Independent,822,1,823,22
Tamil Nadu,Namakkal,PERUMAL.A,Independent,858,0,858,23
Tamil Nadu,Namakkal,PONMUDI.P,Independent,787,0,787,24
Tamil Nadu,Namakkal,MURALI.V,Independent,2487,0,2487,25
Tamil Nadu,Namakkal,RAMASAMY.N,Independent,1874,0,1874,26
Tamil Nadu,Namakkal,None of the Above,NOTA,15977,25,16002,27
Tamil Nadu,Erode,GOPI P,Indian National Congress,26680,46,26726,1
Tamil Nadu,Erode,SELVAKUMARA CHINNAYAN S,All India Anna Dravida Munnetra Kazhagam,466382,613,466995,2
Tamil Nadu,Erode,SETHUPATHY,Bahujan Samaj Party,5910,7,5917,3
Tamil Nadu,Erode,PAVITHRAVALLI H,Dravida Munnetra Kazhagam,216360,900,217260,4
Tamil Nadu,Erode,GANESHAMURTHI.A,Marumalarchi Dravida Munnetra Kazhagam,254758,674,255432,5
Tamil Nadu,Erode,GUNASEKARAN T.K,United Communist Party of India,1296,2,1298,6
Tamil Nadu,Erode,KUMARASAMY K.K,Aam Aadmi Party,4631,23,4654,7
Tamil Nadu,Erode,PALANIAPPAN JOSIYAR C.M,Communist Party of India (Marxist),518,1,519,8
Tamil Nadu,Erode,THANGARAJ V,Independent,818,0,818,9
Tamil Nadu,Erode,DURAISAMY.A,Independent,609,1,610,10
Tamil Nadu,Erode,MAYILSAMY K,Independent,1585,7,1592,11
Tamil Nadu,Erode,MURUGESAN_S,Independent,1046,0,1046,12
Tamil Nadu,Erode,RAJAGOPAL V,Independent,1967,2,1969,13
Tamil Nadu,Erode,VIJAYAKUMAR S,Independent,7468,10,7478,14
Tamil Nadu,Erode,None of the Above,NOTA,16234,34,16268,15
Tamil Nadu,Tiruppur,E.V.K.S. ELANGOVAN,Indian National Congress,47468,86,47554,1
Tamil Nadu,Tiruppur,N.GURUSAMY,Bahujan Samaj Party,4657,8,4665,2
Tamil Nadu,Tiruppur,V.SATHYABAMA,All India Anna Dravida Munnetra Kazhagam,442300,478,442778,3
Tamil Nadu,Tiruppur,K.SUBBARAYAN,Communist Party of India,33283,48,33331,4
Tamil Nadu,Tiruppur,M.SENTHILNATHAN,Dravida Munnetra Kazhagam,204866,545,205411,5
Tamil Nadu,Tiruppur,N.DINESHKUMAR,DMDK,263052,411,263463,6
Tamil Nadu,Tiruppur,R.GOPALSAMY,Lok Seva Parishad,2166,1,2167,7
Tamil Nadu,Tiruppur,R.CHAKRAVARTHI RAJA GOPALA KRISHNAN,Aam Aadmi Party,3076,11,3087,8
Tamil Nadu,Tiruppur,N.SIVAKUMAR,Ulzaipali Makkal Katchy,949,0,949,9
Tamil Nadu,Tiruppur,R.MURUGESAN,MMKA,2009,1,2010,10
Tamil Nadu,Tiruppur,J.LAXMI,Communist Party of India (Marxist),908,0,908,11
Tamil Nadu,Tiruppur,R.SATHYABAMA,Independent,1092,5,1097,12
Tamil Nadu,Tiruppur,R.SATHYABHAMA,Independent,1192,1,1193,13
Tamil Nadu,Tiruppur,K.SENTHILKUMAR,Independent,1925,1,1926,14
Tamil Nadu,Tiruppur,T.S.SENTHILKUMAR,Independent,1150,1,1151,15
Tamil Nadu,Tiruppur,P.SELVABOOBATHI,Independent,4264,0,4264,16
Tamil Nadu,Tiruppur,S.K.DINESHKUMAR,Independent,1820,0,1820,17
Tamil Nadu,Tiruppur,R.NANDHAKUMAR,Independent,899,1,900,18
Tamil Nadu,Tiruppur,M.PALANISAMY,Independent,4074,0,4074,19
Tamil Nadu,Tiruppur,P.BALASUBRAMANIYAN,Independent,916,0,916,20
Tamil Nadu,Tiruppur,A.PONNUSAMY,Independent,1191,2,1193,21
Tamil Nadu,Tiruppur,R.R.MURUGAN,Independent,6413,9,6422,22
Tamil Nadu,Tiruppur,A.MOGHEETH KHAN,Independent,1038,0,1038,23
Tamil Nadu,Tiruppur,M.RAJENDRAN,Independent,1990,1,1991,24
Tamil Nadu,Tiruppur,PASTOR A.JAMES,Independent,1150,3,1153,25
Tamil Nadu,Tiruppur,A.K.SHEIKDAVOOD,Independent,788,0,788,26
Tamil Nadu,Tiruppur,None of the Above,NOTA,13908,33,13941,27
Tamil Nadu,Nilgiris ,"RAJA, A.",Dravida Munnetra Kazhagam,357274,1486,358760,1
Tamil Nadu,Nilgiris ,"KALA, M.",Bahujan Samaj Party,3375,2,3377,2
Tamil Nadu,Nilgiris ,"GANDHI, P.",Indian National Congress,37680,22,37702,3
Tamil Nadu,Nilgiris ,"GOPALAKRISHNAN, C.",All India Anna Dravida Munnetra Kazhagam,463270,430,463700,4
Tamil Nadu,Nilgiris ,"RANI, M.T.",Aam Aadmi Party,12498,27,12525,5
Tamil Nadu,Nilgiris ,"ESWARAN, T.",MMKA,1649,6,1655,6
Tamil Nadu,Nilgiris ,"GUNASEKARAN, K.",Republican Party of India (A),1645,5,1650,7
Tamil Nadu,Nilgiris ,"PONNUSAMY, P.",Communist Party of India (Marxist),2726,7,2733,8
Tamil Nadu,Nilgiris ,"SUBRAMANIYAM, P.",Independent,1711,0,1711,9
Tamil Nadu,Nilgiris ,"DR.BALAN, P.P.",Independent,2701,3,2704,10
Tamil Nadu,Nilgiris ,None of the Above,NOTA,46495,64,46559,11
Tamil Nadu,Coimbatore,"GANESHKUMAR, K.",Dravida Munnetra Kazhagam,216582,501,217083,1
Tamil Nadu,Coimbatore,"TAMILNADU SELVAM, ERA.",Bahujan Samaj Party,1955,4,1959,2
Tamil Nadu,Coimbatore,"NATARAJAN, P.R.",Communist Party of India  (Marxist),34124,73,34197,3
Tamil Nadu,Coimbatore,"NAGARAJAN, P.",All India Anna Dravida Munnetra Kazhagam,430909,808,431717,4
Tamil Nadu,Coimbatore,"PRABHU, R.",Indian National Congress,56891,71,56962,5
Tamil Nadu,Coimbatore,"RADHAKRISHNAN, C.P.",Bharatiya Janata Party,388911,790,389701,6
Tamil Nadu,Coimbatore,"KALAPIRAR KUPPUSAMY, C.",Communist Party of India (Marxist),1051,0,1051,7
Tamil Nadu,Coimbatore,"CHANDRAN, D.",Communist Party of India (Marxist-Lenninist) (Liberation),1358,2,1360,8
Tamil Nadu,Coimbatore,PON CHANDRAN.,Aam Aadmi Party,6664,16,6680,9
Tamil Nadu,Coimbatore,"DORAISAMY, A.",MMKA,550,0,550,10
Tamil Nadu,Coimbatore,"JAGADEESWARAN, S.",Ulzaipali Makkal Katchy,596,0,596,11
Tamil Nadu,Coimbatore,"ABDUL SALAM, A.",Independent,766,0,766,12
Tamil Nadu,Coimbatore,"ALPHONESRAJ, M.",Independent,1305,1,1306,13
Tamil Nadu,Coimbatore,ANBUSELVAN.,Independent,799,0,799,14
Tamil Nadu,Coimbatore,"RAJAGOPAL, M.",Independent,1231,1,1232,15
Tamil Nadu,Coimbatore,"KANAGASABAPATHY, G.",Independent,2329,0,2329,16
Tamil Nadu,Coimbatore,"KITTUSAMY, P.",Independent,2122,0,2122,17
Tamil Nadu,Coimbatore,"SUBASH, K.R.",Independent,1755,1,1756,18
Tamil Nadu,Coimbatore,"TAMILSELVAN, K.",Independent,639,1,640,19
Tamil Nadu,Coimbatore,"NAGARAJ, S.",Independent,1699,0,1699,20
Tamil Nadu,Coimbatore,"MOHANRAJ, K.",Independent,607,0,607,21
Tamil Nadu,Coimbatore,"RANJITHKUMAR, M.",Independent,1099,1,1100,22
Tamil Nadu,Coimbatore,"RADHAKRISHNAN, R.",Independent,1671,1,1672,23
Tamil Nadu,Coimbatore,"JERLLD AMALAJOTHI, I.",Independent,858,0,858,24
Tamil Nadu,Coimbatore,"SRIDHARAN, S.",Independent,450,0,450,25
Tamil Nadu,Coimbatore,None of the Above,NOTA,17391,37,17428,26
Tamil Nadu,Pollachi,ESWARAN.E.R.,Bharatiya Janata Party,275356,762,276118,1
Tamil Nadu,Pollachi,SELVARAJ,Indian National Congress,29967,47,30014,2
Tamil Nadu,Pollachi,PONGALUR PALANISAMY.N,Dravida Munnetra Kazhagam,251090,739,251829,3
Tamil Nadu,Pollachi,MAHENDRAN.C,All India Anna Dravida Munnetra Kazhagam,416366,726,417092,4
Tamil Nadu,Pollachi,MANOHARAN.M,Bahujan Samaj Party,3950,3,3953,5
Tamil Nadu,Pollachi,SATHISH KUMAR .L,Samajwadi Party,895,0,895,6
Tamil Nadu,Pollachi,EASWARAN . R,Independent,882,9,891,7
Tamil Nadu,Pollachi,KATHIRAVAN. K,Independent,626,0,626,8
Tamil Nadu,Pollachi,KATHIRESAN. L,Independent,1519,4,1523,9
Tamil Nadu,Pollachi,KARTHIKEYAN. PON,Independent,494,0,494,10
Tamil Nadu,Pollachi,DEIVASIGAMANI.K,Independent,834,0,834,11
Tamil Nadu,Pollachi,PALANISAMY. N,Independent,2182,10,2192,12
Tamil Nadu,Pollachi,PALANISAMY. V,Independent,2466,6,2472,13
Tamil Nadu,Pollachi,PRABHU.  J,Independent,1599,0,1599,14
Tamil Nadu,Pollachi,MAHENDRAN. M,Independent,1170,1,1171,15
Tamil Nadu,Pollachi,MARY STELLA. M,Independent,4942,0,4942,16
Tamil Nadu,Pollachi,RAMASAMY. K,Independent,2071,0,2071,17
Tamil Nadu,Pollachi,RAJENDRAN. M,Independent,1004,0,1004,18
Tamil Nadu,Pollachi,None of the Above,NOTA,12908,39,12947,19
Tamil Nadu,Dindigul,UDHAYA KUMAR .M,All India Anna Dravida Munnetra Kazhagam,510009,453,510462,1
Tamil Nadu,Dindigul,GANDHIRAJAN S,Dravida Munnetra Kazhagam,381992,625,382617,2
Tamil Nadu,Dindigul,KRISHNAMOORTHY A,DMDK,93706,88,93794,3
Tamil Nadu,Dindigul,CHITTHAN N.S.V,Indian National Congress,35615,17,35632,4
Tamil Nadu,Dindigul,BAGATSINGH PALANICHAMY M,Bahujan Samaj Party,1903,0,1903,5
Tamil Nadu,Dindigul,PANDI.N,Communist Party of India  (Marxist),19421,34,19455,6
Tamil Nadu,Dindigul,ELANCHEZHIAN.S,Aam Aadmi Party,3391,4,3395,7
Tamil Nadu,Dindigul,BALASUBRAMANI.R,Ulzaipali Makkal Katchy,553,0,553,8
Tamil Nadu,Dindigul,KUPPURAJ C,Independent,627,0,627,9
Tamil Nadu,Dindigul,CHANDRAMOHAN P,Independent,1259,2,1261,10
Tamil Nadu,Dindigul,SUDHARSHNAR.K,Independent,591,1,592,11
Tamil Nadu,Dindigul,THANGAPANDIAN.R,Independent,786,0,786,12
Tamil Nadu,Dindigul,DHANDAPANI.K,Independent,863,0,863,13
Tamil Nadu,Dindigul,NAGARAJAN V,Independent,1202,0,1202,14
Tamil Nadu,Dindigul,PAULDURAI  V K,Independent,2604,0,2604,15
Tamil Nadu,Dindigul,MANIVANNAN N,Independent,5859,0,5859,16
Tamil Nadu,Dindigul,RAJENDHRAN. R,Independent,7580,0,7580,17
Tamil Nadu,Dindigul,VENKATESAN G,Independent,3588,0,3588,18
Tamil Nadu,Dindigul,None of the Above,NOTA,10580,11,10591,19
Tamil Nadu,Karur,"KRISHNAN, N.S.",DMDK,76447,113,76560,1
Tamil Nadu,Karur,"CHINNASAMY, M.",Dravida Munnetra Kazhagam,344597,878,345475,2
Tamil Nadu,Karur,"THAMBIDURAI,M.",All India Anna Dravida Munnetra Kazhagam,539128,1594,540722,3
Tamil Nadu,Karur,"MARUTHAIVEERAN, V.",Bahujan Samaj Party,5693,1,5694,4
Tamil Nadu,Karur,"JOTHIMANI, S.",Indian National Congress,30420,39,30459,5
Tamil Nadu,Karur,"SARASWATHY, K.",Communist Party of India (Marxist),809,4,813,6
Tamil Nadu,Karur,"MANEESHANKAR, M.G.",RSPS,1276,0,1276,7
Tamil Nadu,Karur,"MURUGESAN, M.",Samajwadi Party,847,1,848,8
Tamil Nadu,Karur,"RAVICHANDRAN, V.",Ulzaipali Makkal Katchy,563,0,563,9
Tamil Nadu,Karur,"VALAIYAPATHI, R.",Aam Aadmi Party,2432,8,2440,10
Tamil Nadu,Karur,"KANNAN, S.",Independent,666,2,668,11
Tamil Nadu,Karur,"KANNAN, P.",Independent,1434,2,1436,12
Tamil Nadu,Karur,"GOWRIMANI, S.",Independent,1433,0,1433,13
Tamil Nadu,Karur,"CHINNASAMY, M.",Independent,3719,0,3719,14
Tamil Nadu,Karur,"CHINNASAMY, V.",Independent,2108,0,2108,15
Tamil Nadu,Karur,"SELVARAJ, S.",Independent,3552,0,3552,16
Tamil Nadu,Karur,"THAMILALAGAN, A.",Independent,1387,0,1387,17
Tamil Nadu,Karur,"BALASUBRAMANIAN,  G.",Independent,4482,4,4486,18
Tamil Nadu,Karur,"PRAKASH, N.",Independent,4280,0,4280,19
Tamil Nadu,Karur,"MAHENDRAN, T.",Independent,1024,0,1024,20
Tamil Nadu,Karur,"MANICKAVASAGAM, A.",Independent,831,0,831,21
Tamil Nadu,Karur,"MURUGAAN, N.",Independent,436,1,437,22
Tamil Nadu,Karur,"RAVI, S.P.",Independent,732,0,732,23
Tamil Nadu,Karur,"VIGNESHWARAN, M.",Independent,981,0,981,24
Tamil Nadu,Karur,"VIJAY, J.",Independent,847,0,847,25
Tamil Nadu,Karur,None of the Above,NOTA,13733,30,13763,26
Tamil Nadu,Tiruchirappalli,ANBHALAGAN.MU,Dravida Munnetra Kazhagam,306968,1034,308002,1
Tamil Nadu,Tiruchirappalli,KUMAR.P,All India Anna Dravida Munnetra Kazhagam,457377,1101,458478,2
Tamil Nadu,Tiruchirappalli,SARUBALA  R THONDAIMAN,Indian National Congress,51458,79,51537,3
Tamil Nadu,Tiruchirappalli,NATARAJAN.S,Bahujan Samaj Party,1707,3,1710,4
Tamil Nadu,Tiruchirappalli,VIJAYKUMAR.AMG,DMDK,94567,218,94785,5
Tamil Nadu,Tiruchirappalli,SRIDHAR.S,Communist Party of India  (Marxist),16962,77,17039,6
Tamil Nadu,Tiruchirappalli,ANWAR DEEN.S,Samata Party,731,0,731,7
Tamil Nadu,Tiruchirappalli,ASAITHAMBI.PALA,Communist Party of India (Marxist-Lenninist) (Liberation),1419,6,1425,8
Tamil Nadu,Tiruchirappalli,RAVI.P,Aam Aadmi Party,4870,15,4885,9
Tamil Nadu,Tiruchirappalli,KARUNAKARAN.M,Lok Seva Parishad,605,1,606,10
Tamil Nadu,Tiruchirappalli,JOTHI.P,Samajwadi Party,1001,2,1003,11
Tamil Nadu,Tiruchirappalli,ARUNACHALAM.A,Independent,3238,1,3239,12
Tamil Nadu,Tiruchirappalli,ANBALAGAN.M,Independent,630,6,636,13
Tamil Nadu,Tiruchirappalli,ASRAF ALI.M,Independent,733,1,734,14
Tamil Nadu,Tiruchirappalli,RAGAVAN. R,Independent,1283,0,1283,15
Tamil Nadu,Tiruchirappalli,ESWARAN.J,Independent,2484,0,2484,16
Tamil Nadu,Tiruchirappalli,KUMAR.P,Independent,4077,0,4077,17
Tamil Nadu,Tiruchirappalli,SHADHICK BATCHA.A,Independent,3082,1,3083,18
Tamil Nadu,Tiruchirappalli,SUNDARRAJ.S,Independent,784,0,784,19
Tamil Nadu,Tiruchirappalli,"THADDAUS FERNANDEZ,",Independent,751,0,751,20
Tamil Nadu,Tiruchirappalli,DINESHKUMAR.G,Independent,1119,0,1119,21
Tamil Nadu,Tiruchirappalli,PALANIVEL.P,Independent,687,0,687,22
Tamil Nadu,Tiruchirappalli,BADHUSHA.M,Independent,669,0,669,23
Tamil Nadu,Tiruchirappalli,BALA KRISHNAN.K,Independent,485,0,485,24
Tamil Nadu,Tiruchirappalli,MOHANDASS.M,Independent,355,0,355,25
Tamil Nadu,Tiruchirappalli,LARANCE.Y,Independent,1198,0,1198,26
Tamil Nadu,Tiruchirappalli,VIJAYAKUMAR.P,Independent,680,0,680,27
Tamil Nadu,Tiruchirappalli,VEERAMALAI.A,Independent,589,0,589,28
Tamil Nadu,Tiruchirappalli,SRIDEVI.S,Independent,2348,0,2348,29
Tamil Nadu,Tiruchirappalli,None of the Above,NOTA,22798,50,22848,30
Tamil Nadu,Perambalur,"RAJASEKARAN,  M.,",Indian National Congress,31971,27,31998,1
Tamil Nadu,Perambalur,"SELVARAJ, V.M.",Bahujan Samaj Party,2922,2,2924,2
Tamil Nadu,Perambalur,"PARIVENDAR  PACHAMUTHU, T.R.",Bharatiya Janata Party,237291,1596,238887,3
Tamil Nadu,Perambalur,"SEEMANUR  PRABU, S.",Dravida Munnetra Kazhagam,248661,984,249645,4
Tamil Nadu,Perambalur,"MARUTHARAJAA, R.P.",All India Anna Dravida Munnetra Kazhagam,462077,616,462693,5
Tamil Nadu,Perambalur,"RAMAR YADAV,  K.",Tamil Nadu Makkal Congress,6324,0,6324,6
Tamil Nadu,Perambalur,"THOZHAR  TAMILSELVAN,  P.",United Communist Party of India,1506,3,1509,7
Tamil Nadu,Perambalur,"ABDUL RAHMAN,  R.",Independent,1018,0,1018,8
Tamil Nadu,Perambalur,"SIVAPERUMAL,  K.",Independent,985,1,986,9
Tamil Nadu,Perambalur,"CHINNA RAJENDRAN, C.",Independent,876,1,877,10
Tamil Nadu,Perambalur,"SUBRAMANI, D.",Independent,1201,0,1201,11
Tamil Nadu,Perambalur,"ANBIL  THANGAMANI, K.",Independent,1636,0,1636,12
Tamil Nadu,Perambalur,"PACHAMUTHU, N.",Independent,2762,0,2762,13
Tamil Nadu,Perambalur,"PRABU,  S.",Independent,2211,0,2211,14
Tamil Nadu,Perambalur,"MANI, P.",Independent,1302,0,1302,15
Tamil Nadu,Perambalur,"MARUTHARAJ, P.",Independent,3940,0,3940,16
Tamil Nadu,Perambalur,"RAJASEKAR, T.",Independent,1490,0,1490,17
Tamil Nadu,Perambalur,"RENGARAJU, M.",Independent,633,0,633,18
Tamil Nadu,Perambalur,"VADIVELU, P.",Independent,1820,1,1821,19
Tamil Nadu,Perambalur,"VISWANATHAN, A.",Independent,2369,0,2369,20
Tamil Nadu,Perambalur,"VELAYUTHAM, C.",Independent,2995,0,2995,21
Tamil Nadu,Perambalur,None of the Above,NOTA,11580,25,11605,22
Tamil Nadu,Cuddalore ,ARUNMOZHITHEVAN.A,All India Anna Dravida Munnetra Kazhagam,480352,1077,481429,1
Tamil Nadu,Cuddalore ,ALAGIRI.S,Indian National Congress,26626,24,26650,2
Tamil Nadu,Cuddalore ,SENTHILMURUGAN.S,Bahujan Samaj Party,2641,1,2642,3
Tamil Nadu,Cuddalore ,NANDAGOPALAKRISHNAN.K.,Dravida Munnetra Kazhagam,277693,611,278304,4
Tamil Nadu,Cuddalore ,BALASUBRAMANIAN.K,Communist Party of India,11109,13,11122,5
Tamil Nadu,Cuddalore ,JAYASANKAR.C.R,DMDK,147014,592,147606,6
Tamil Nadu,Cuddalore ,SYED MOHIDEEN.A.G.,Aam Aadmi Party,3468,5,3473,7
Tamil Nadu,Cuddalore ,SHRUTI MISHRA,UPI,941,3,944,8
Tamil Nadu,Cuddalore ,ANANDHARAJAN.S,Independent,1309,0,1309,9
Tamil Nadu,Cuddalore ,GIRIJA.S,Independent,650,0,650,10
Tamil Nadu,Cuddalore ,SIVAGNANASAMBANDAN.T,Independent,1257,0,1257,11
Tamil Nadu,Cuddalore ,SENGUTTUVAN.R,Independent,862,0,862,12
Tamil Nadu,Cuddalore ,THIRUNAVUKKARASU,Independent,1782,0,1782,13
Tamil Nadu,Cuddalore ,BASKAR.A,Independent,872,0,872,14
Tamil Nadu,Cuddalore ,RADHAKRISHNAN.K.R,Independent,1370,0,1370,15
Tamil Nadu,Cuddalore ,RAJKUMAR.V,Independent,7678,0,7678,16
Tamil Nadu,Cuddalore ,JAISHANKAR.P.,Independent,6250,0,6250,17
Tamil Nadu,Cuddalore ,None of the Above,NOTA,10334,4,10338,18
Tamil Nadu,Chidambaram ,"RAJENDRAN, K",Bahujan Samaj Party,5178,1,5179,1
Tamil Nadu,Chidambaram ,"CHANDRAKASI, M",All India Anna Dravida Munnetra Kazhagam,428858,678,429536,2
Tamil Nadu,Chidambaram ,"VALLAL PERUMAN, P",Indian National Congress,28981,7,28988,3
Tamil Nadu,Chidambaram ,"EZHUMALAI, V",Akhil Bharat Hindu Mahasabha,6824,0,6824,4
Tamil Nadu,Chidambaram ,SUDHAMANIRATHINEM,Pattali Makkal Katchi,278327,689,279016,5
Tamil Nadu,Chidambaram ,"THIRUMAAVALAVAN, THOL",Viduthalai Chiruthaigal Katchi,300351,690,301041,6
Tamil Nadu,Chidambaram ,"ANANDAN ALIAS KAVIGNAR ANANTHAMAALAI, S",Independent,8875,0,8875,7
Tamil Nadu,Chidambaram ,"SANMUGAM, A",Independent,1071,0,1071,8
Tamil Nadu,Chidambaram ,"CHANDRAGASAN, N",Independent,1182,0,1182,9
Tamil Nadu,Chidambaram ,"SENTHAMIZHSELVI, K",Independent,1468,1,1469,10
Tamil Nadu,Chidambaram ,"THIRUSANGU, A",Independent,3370,0,3370,11
Tamil Nadu,Chidambaram ,"PAZHANIVEL, P",Independent,1772,0,1772,12
Tamil Nadu,Chidambaram ,"PARVATHI, S",Independent,1543,0,1543,13
Tamil Nadu,Chidambaram ,"PUSHPARAJ, S",Independent,1523,0,1523,14
Tamil Nadu,Chidambaram ,"RAJKUMAR, S",Independent,4896,0,4896,15
Tamil Nadu,Chidambaram ,None of the Above,NOTA,12127,11,12138,16
Tamil Nadu,Mayiladuthurai,BHARATHI MOHAN R.K,All India Anna Dravida Munnetra Kazhagam,512756,973,513729,1
Tamil Nadu,Mayiladuthurai,MANI SHANKAR AIYAR,Indian National Congress,58292,173,58465,2
Tamil Nadu,Mayiladuthurai,RASAVELU.K,Bahujan Samaj Party,3652,2,3654,3
Tamil Nadu,Mayiladuthurai,AGORAM. K,Pattali Makkal Katchi,143617,468,144085,4
Tamil Nadu,Mayiladuthurai,IRULAPPAN.V,Samajwadi Party,2642,1,2643,5
Tamil Nadu,Mayiladuthurai,HYDER ALI.S,MAMAK,236052,627,236679,6
Tamil Nadu,Mayiladuthurai,ARUMUGAM. C,Independent,2028,0,2028,7
Tamil Nadu,Mayiladuthurai,GUNASEKARAN.N,Independent,4144,5,4149,8
Tamil Nadu,Mayiladuthurai,SHAMSUDEEN. M,Independent,2303,0,2303,9
Tamil Nadu,Mayiladuthurai,THIRUNAVUKKARASU. R,Independent,4713,1,4714,10
Tamil Nadu,Mayiladuthurai,TIMOTHY.T,Independent,2326,1,2327,11
Tamil Nadu,Mayiladuthurai,NAGARAJAN. M,Independent,1066,0,1066,12
Tamil Nadu,Mayiladuthurai,PANDIYAN .R,Independent,11613,0,11613,13
Tamil Nadu,Mayiladuthurai,FATHIMA ALIAS BHARATHI. R,Independent,7582,0,7582,14
Tamil Nadu,Mayiladuthurai,MUNUSAMY.V,Independent,1994,0,1994,15
Tamil Nadu,Mayiladuthurai,RAGURAMAN. A,Independent,7214,0,7214,16
Tamil Nadu,Mayiladuthurai,REVATHI.A,Independent,6284,2,6286,17
Tamil Nadu,Mayiladuthurai,JARINA BEGAM. N,Independent,1056,0,1056,18
Tamil Nadu,Mayiladuthurai,JEYAPRAKASH. B,Independent,770,0,770,19
Tamil Nadu,Mayiladuthurai,None of the Above,NOTA,13152,29,13181,20
Tamil Nadu,Nagapattinam ,GOPAL. DR. K,All India Anna Dravida Munnetra Kazhagam,433242,932,434174,1
Tamil Nadu,Nagapattinam ,SENTHILPANDIAN. THALAI. T.A.P,Indian National Congress,23922,45,23967,2
Tamil Nadu,Nagapattinam ,THANGASAMY. V,Bahujan Samaj Party,1849,2,1851,3
Tamil Nadu,Nagapattinam ,PALANISAMY. G,Communist Party of India,90203,110,90313,4
Tamil Nadu,Nagapattinam ,VIJAYAN. A.K.S,Dravida Munnetra Kazhagam,326968,1127,328095,5
Tamil Nadu,Nagapattinam ,VADIVEL RAVANAN,Pattali Makkal Katchi,43325,181,43506,6
Tamil Nadu,Nagapattinam ,DEVAKI. G,Independent,1845,2,1847,7
Tamil Nadu,Nagapattinam ,MURUGAIYAN. K,Independent,1033,0,1033,8
Tamil Nadu,Nagapattinam ,MOHAN. G,Independent,1752,2,1754,9
Tamil Nadu,Nagapattinam ,None of the Above,NOTA,15617,45,15662,10
Tamil Nadu,Thanjavur,ARANGARAJAN.M,Bahujan Samaj Party,2252,1,2253,1
Tamil Nadu,Thanjavur,KRISHNASAMY VANDAYAR.T,Indian National Congress,30170,62,30232,2
Tamil Nadu,Thanjavur,TAMILSELVI.S,Communist Party of India  (Marxist),23172,43,23215,3
Tamil Nadu,Thanjavur,PARASURAMAN.K,All India Anna Dravida Munnetra Kazhagam,509587,720,510307,4
Tamil Nadu,Thanjavur,BAALU.T.R,Dravida Munnetra Kazhagam,364449,1739,366188,5
Tamil Nadu,Thanjavur,MURUGANANTHAM.M,Bharatiya Janata Party,58447,74,58521,6
Tamil Nadu,Thanjavur,MUMMOORTHI.S@S.M.MOORTHY,NMK,2509,2,2511,7
Tamil Nadu,Thanjavur,GUNASEKARAN.T,Independent,894,0,894,8
Tamil Nadu,Thanjavur,SIVAKUMAR.V,Independent,1511,0,1511,9
Tamil Nadu,Thanjavur,PANASAI ARANGAN.N,Independent,1830,0,1830,10
Tamil Nadu,Thanjavur,MADHAVAN.T,Independent,1169,0,1169,11
Tamil Nadu,Thanjavur,RAJKUMAR.R,Independent,1415,0,1415,12
Tamil Nadu,Thanjavur,None of the Above,NOTA,12199,13,12212,13
Tamil Nadu,Sivaganga,KARTI P CHIDAMBARAM,Indian National Congress,104606,72,104678,1
Tamil Nadu,Sivaganga,KRISHNAN S,Communist Party of India,20433,40,20473,2
Tamil Nadu,Sivaganga,SENTHILNATHAN PR,All India Anna Dravida Munnetra Kazhagam,475726,267,475993,3
Tamil Nadu,Sivaganga,DHURAI RAAJ SUBHA,Dravida Munnetra Kazhagam,246199,409,246608,4
Tamil Nadu,Sivaganga,RAKKAMUTHU V,Bahujan Samaj Party,3055,1,3056,5
Tamil Nadu,Sivaganga,RAJA H,Bharatiya Janata Party,133579,184,133763,6
Tamil Nadu,Sivaganga,KALAIMANI K,MMKA,1438,0,1438,7
Tamil Nadu,Sivaganga,THAMILARIMA S,Aam Aadmi Party,2130,1,2131,8
Tamil Nadu,Sivaganga,BALU S,Tamil Nadu Makkal Congress,2196,0,2196,9
Tamil Nadu,Sivaganga,RAJASEKAR.S @ S.R.THEVAR,DFBL,4028,1,4029,10
Tamil Nadu,Sivaganga,VELLADHURAI A,ETMK,3023,0,3023,11
Tamil Nadu,Sivaganga,KARTHIKARAJAN T,Independent,873,0,873,12
Tamil Nadu,Sivaganga,GUNASEKARAN P,Independent,1268,1,1269,13
Tamil Nadu,Sivaganga,SARAVANAN M,Independent,2100,0,2100,14
Tamil Nadu,Sivaganga,SIVAGNANAM AL,Independent,1007,0,1007,15
Tamil Nadu,Sivaganga,ARIMAZHAM THIYAGI SUBRAMANIAN MUTHURAJA M,Independent,3021,0,3021,16
Tamil Nadu,Sivaganga,SELVARAJ A,Independent,2050,0,2050,17
Tamil Nadu,Sivaganga,NATCHIAPPAN SP,Independent,794,0,794,18
Tamil Nadu,Sivaganga,NELSON A,Independent,2986,1,2987,19
Tamil Nadu,Sivaganga,PALANI S,Independent,1699,0,1699,20
Tamil Nadu,Sivaganga,BALAKRISHNAN P,Independent,949,0,949,21
Tamil Nadu,Sivaganga,PERIYAKARUPPAN S,Independent,837,0,837,22
Tamil Nadu,Sivaganga,MURUGAN P,Independent,736,0,736,23
Tamil Nadu,Sivaganga,MEGARAJ MALLAR,Independent,565,0,565,24
Tamil Nadu,Sivaganga,RADHAKRISHNAN A,Independent,641,0,641,25
Tamil Nadu,Sivaganga,RAJA A,Independent,1337,0,1337,26
Tamil Nadu,Sivaganga,LENIN M,Independent,741,0,741,27
Tamil Nadu,Sivaganga,None of the Above,NOTA,8031,11,8042,28
Tamil Nadu,Madurai,R.GOPALAKRISHNAN,All India Anna Dravida Munnetra Kazhagam,453366,419,453785,1
Tamil Nadu,Madurai,D SIVAMUTHU KUMAR,DMDK,146632,119,146751,2
Tamil Nadu,Madurai,A THAVAMANI,Bahujan Samaj Party,1252,1,1253,3
Tamil Nadu,Madurai,T.N.BHARATH NACHIAPPAN,Indian National Congress,32140,14,32154,4
Tamil Nadu,Madurai,B.VIKRAMAN,Communist Party of India  (Marxist),30087,39,30126,5
Tamil Nadu,Madurai,V VELUSAMY,Dravida Munnetra Kazhagam,254064,297,254361,6
Tamil Nadu,Madurai,M.KAMACIS,Aam Aadmi Party,5369,9,5378,7
Tamil Nadu,Madurai,M.MOHAMMED ALI,Samata Party,900,0,900,8
Tamil Nadu,Madurai,K. RAJA,DFBL,1472,2,1474,9
Tamil Nadu,Madurai,N ALAGU MUTHU VELAYUDAM,Independent,483,0,483,10
Tamil Nadu,Madurai,S.ARIVUDAINAMBI,Independent,448,0,448,11
Tamil Nadu,Madurai,V.ANDICHAMY,Independent,4467,0,4467,12
Tamil Nadu,Madurai,S.GANESAN,Independent,363,0,363,13
Tamil Nadu,Madurai,A.KANNAN,Independent,423,0,423,14
Tamil Nadu,Madurai,G.KANNAN,Independent,556,0,556,15
Tamil Nadu,Madurai,V.KARUPPAIAH,Independent,2054,0,2054,16
Tamil Nadu,Madurai,P.GOPALAKRISHNAN,Independent,6289,0,6289,17
Tamil Nadu,Madurai,M.GOPALAKRISHNAN,Independent,2754,0,2754,18
Tamil Nadu,Madurai,P.CHANDRABOSE,Independent,719,0,719,19
Tamil Nadu,Madurai,K.THANGAPANDI,Independent,666,0,666,20
Tamil Nadu,Madurai,BHARATHI KANNAMMA,Independent,1222,4,1226,21
Tamil Nadu,Madurai,J.MANIKANDESWARAN,Independent,1561,2,1563,22
Tamil Nadu,Madurai,G.MARIA JOSEPH XAVIOUR,Independent,565,0,565,23
Tamil Nadu,Madurai,S.MANICKAVASAGAM,Independent,339,0,339,24
Tamil Nadu,Madurai,M.MEENAKSHISUNDARAM,Independent,432,0,432,25
Tamil Nadu,Madurai,K.K.RAMESH,Independent,424,0,424,26
Tamil Nadu,Madurai,T.RAMASAMY,Independent,430,0,430,27
Tamil Nadu,Madurai,P.RAMASUBRAMANIAN,Independent,572,0,572,28
Tamil Nadu,Madurai,V.G.RAMDOSS,Independent,2738,2,2740,29
Tamil Nadu,Madurai,M VENKATESAN,Independent,392,0,392,30
Tamil Nadu,Madurai,P.JEYAKUMAR,Independent,957,0,957,31
Tamil Nadu,Madurai,None of the Above,NOTA,19757,8,19765,32
Tamil Nadu,Theni ,"AARON RASHID, J.M.",Indian National Congress,71398,34,71432,1
Tamil Nadu,Theni ,"THANGADURAI, V.",Bahujan Samaj Party,5297,2,5299,2
Tamil Nadu,Theni ,"PARTHIPAN, R.",All India Anna Dravida Munnetra Kazhagam,570919,335,571254,3
Tamil Nadu,Theni ,PON. MUTHURAMALINGAM,Dravida Munnetra Kazhagam,256501,221,256722,4
Tamil Nadu,Theni ,"ALAGUSUNDARAM, K.",Marumalarchi Dravida Munnetra Kazhagam,134223,139,134362,5
Tamil Nadu,Theni ,"KRISHNAMOORTHY, K.",Communist Party of India (Marxist),946,0,946,6
Tamil Nadu,Theni ,"MEENAKSHI SUNDARAM, G.K.",Samajwadi Party,1107,0,1107,7
Tamil Nadu,Theni ,"RAMPRAKASH, J.",Aam Aadmi Party,3208,5,3213,8
Tamil Nadu,Theni ,"VOLTAIRE, M.J.",SOCIALIST UNITY CENTRE OF INDIA (COMMUNIST),696,0,696,9
Tamil Nadu,Theni ,"ASATH, M.M.",Independent,1082,0,1082,10
Tamil Nadu,Theni ,"RAMAYA, R.",Independent,742,0,742,11
Tamil Nadu,Theni ,"INIYAVAN, R.",Independent,739,0,739,12
Tamil Nadu,Theni ,"INNASIMUTHU, M.S.",Independent,991,0,991,13
Tamil Nadu,Theni ,"KANNAN, S.",Independent,1273,0,1273,14
Tamil Nadu,Theni ,"KARUPPIAH, R.",Independent,679,0,679,15
Tamil Nadu,Theni ,MAMALLAN THA. KANAGAMUTHU,Independent,2680,1,2681,16
Tamil Nadu,Theni ,"SENTHIL RAJAN MALLAR, K.",Independent,2905,3,2908,17
Tamil Nadu,Theni ,"MANI, S.V.",Independent,1349,0,1349,18
Tamil Nadu,Theni ,"MARIAPPAN, S.K.",Independent,3521,0,3521,19
Tamil Nadu,Theni ,"MOHAMED MIAKHAN, P.",Independent,1954,0,1954,20
Tamil Nadu,Theni ,"MUTHURAMALINGAM, M.",Independent,859,0,859,21
Tamil Nadu,Theni ,"RABEEK, K.",Independent,767,0,767,22
Tamil Nadu,Theni ,"RAJA, V.",Independent,695,0,695,23
Tamil Nadu,Theni ,None of the Above,NOTA,10300,12,10312,24
Tamil Nadu,Virudhunagar,RETHINAVELU S,Dravida Munnetra Kazhagam,241089,416,241505,1
Tamil Nadu,Virudhunagar,KAMALAVELSELVAN,Bahujan Samaj Party,1684,1,1685,2
Tamil Nadu,Virudhunagar,SAMUELRAJ K,Communist Party of India  (Marxist),20107,50,20157,3
Tamil Nadu,Virudhunagar,MANICKAM TAGORE B,Indian National Congress,38439,43,38482,4
Tamil Nadu,Virudhunagar,RADHAKRISHNAN T,All India Anna Dravida Munnetra Kazhagam,406232,462,406694,5
Tamil Nadu,Virudhunagar,KARTHIKAISAMY P,Communist Party of India (Marxist),2247,2,2249,6
Tamil Nadu,Virudhunagar,SANTHANA KRISHNAN G,Tamil Nadu Makkal Congress,3411,0,3411,7
Tamil Nadu,Virudhunagar,PRADEEPKUMAR D,Lok Seva Parishad,681,0,681,8
Tamil Nadu,Virudhunagar,MAHALINGAM T,DFBL,1017,0,1017,9
Tamil Nadu,Virudhunagar,MOHANRAJ J,JJ,1516,1,1517,10
Tamil Nadu,Virudhunagar,VAIKO,Marumalarchi Dravida Munnetra Kazhagam,260317,826,261143,11
Tamil Nadu,Virudhunagar,KANNAN G,Independent,1133,0,1133,12
Tamil Nadu,Virudhunagar,SANKAR A,Independent,532,0,532,13
Tamil Nadu,Virudhunagar,SATHESH M,Independent,903,0,903,14
Tamil Nadu,Virudhunagar,SURESH GANDHI C,Independent,711,0,711,15
Tamil Nadu,Virudhunagar,SOLAIRAJ K,Independent,2721,0,2721,16
Tamil Nadu,Virudhunagar,SOUNDRAPANDIYAN K,Independent,3470,0,3470,17
Tamil Nadu,Virudhunagar,DHANUSHKODI M,Independent,2522,0,2522,18
Tamil Nadu,Virudhunagar,PALANICHAMY MALLAR P,Independent,700,0,700,19
Tamil Nadu,Virudhunagar,PANDIARAJAN R,Independent,922,0,922,20
Tamil Nadu,Virudhunagar,PALPANDI S DR,Independent,2342,0,2342,21
Tamil Nadu,Virudhunagar,MANMATHAN M,Independent,714,0,714,22
Tamil Nadu,Virudhunagar,MADHAVAN P,Independent,642,0,642,23
Tamil Nadu,Virudhunagar,MARIMUTHU C,Independent,629,0,629,24
Tamil Nadu,Virudhunagar,RADHAKRISHNAN PV,Independent,1068,0,1068,25
Tamil Nadu,Virudhunagar,LAKSHMI KANDHAN S,Independent,1155,0,1155,26
Tamil Nadu,Virudhunagar,None of the Above,NOTA,12215,10,12225,27
Tamil Nadu,Ramanathapuram,ANWAR RAAJHAA. A ,All India Anna Dravida Munnetra Kazhagam,405470,475,405945,1
Tamil Nadu,Ramanathapuram,MOHAMED JALEEL.S,Dravida Munnetra Kazhagam,286020,601,286621,2
Tamil Nadu,Ramanathapuram,KUPPU RAMU.D,Bharatiya Janata Party,170617,465,171082,3
Tamil Nadu,Ramanathapuram,THIRUNNAVUKKARSAR.Su,Indian National Congress,62061,99,62160,4
Tamil Nadu,Ramanathapuram,NOOR JIYAVUDEEN.M.I,Social Democratic Party of India,12539,2,12541,5
Tamil Nadu,Ramanathapuram,UMA MAGESWARI.R.T,Communist Party of India,12283,29,12312,6
Tamil Nadu,Ramanathapuram,ARASAKUMAR.B.T,DFBL,10930,15,10945,7
Tamil Nadu,Ramanathapuram,GOPAL.R,Independent,3969,0,3969,8
Tamil Nadu,Ramanathapuram,GOKILA.K,Independent,3471,0,3471,9
Tamil Nadu,Ramanathapuram,ANNAMALAI.S,Independent,3106,19,3125,10
Tamil Nadu,Ramanathapuram,MANIVASAGAM,Independent,2683,1,2684,11
Tamil Nadu,Ramanathapuram,SIVAGURUNATHAN.K,Bahujan Samaj Party,2119,4,2123,12
Tamil Nadu,Ramanathapuram,KASIRAJAN.N,Independent,1415,0,1415,13
Tamil Nadu,Ramanathapuram,PALPANDI.C,Independent,1355,0,1355,14
Tamil Nadu,Ramanathapuram,THENNARASU.P,Independent,1321,0,1321,15
Tamil Nadu,Ramanathapuram,SASIKUMAR.S,Independent,1220,0,1220,16
Tamil Nadu,Ramanathapuram,BALAKRISHNAN.S.S,Independent,1171,0,1171,17
Tamil Nadu,Ramanathapuram,SATHIAH.G,Independent,1129,0,1129,18
Tamil Nadu,Ramanathapuram,THIYAGARAJAN.R,Independent,1037,0,1037,19
Tamil Nadu,Ramanathapuram,KANNATHASAN.R,Independent,999,0,999,20
Tamil Nadu,Ramanathapuram,PERIYASAMY.P,Independent,985,0,985,21
Tamil Nadu,Ramanathapuram,AMIRTHA LINGAM.U,Independent,941,0,941,22
Tamil Nadu,Ramanathapuram,VETRIVEL.S,Independent,914,0,914,23
Tamil Nadu,Ramanathapuram,AZHAGU MEENA.A,Independent,835,0,835,24
Tamil Nadu,Ramanathapuram,MURUGESWARI,Independent,814,0,814,25
Tamil Nadu,Ramanathapuram,AYYAPPAN.S,Independent,785,0,785,26
Tamil Nadu,Ramanathapuram,ALLA PITCHAI.E,Independent,747,0,747,27
Tamil Nadu,Ramanathapuram,SUBBIAH.M,Independent,645,0,645,28
Tamil Nadu,Ramanathapuram,VELCHSAMY.R,Independent,577,0,577,29
Tamil Nadu,Ramanathapuram,RAVI.K,Independent,478,0,478,30
Tamil Nadu,Ramanathapuram,MOOKAIYA.S,Independent,423,0,423,31
Tamil Nadu,Ramanathapuram,None of the Above,NOTA,6264,15,6279,32
Tamil Nadu,Thoothukkudi,AYYADURAI. S,Bahujan Samaj Party,3182,23,3205,1
Tamil Nadu,Thoothukkudi,"SHANMUGAM, A.P.C.V.",Indian National Congress,62937,143,63080,2
Tamil Nadu,Thoothukkudi,MOHANRAJ. A,Communist Party of India,14976,17,14993,3
Tamil Nadu,Thoothukkudi,JEGAN. P,Dravida Munnetra Kazhagam,241635,415,242050,4
Tamil Nadu,Thoothukkudi,JEYASINGH THIYAGARAJ NATTERJEE.J,All India Anna Dravida Munnetra Kazhagam,365382,670,366052,5
Tamil Nadu,Thoothukkudi,PUSHPARAYAN.M.,Aam Aadmi Party,26443,33,26476,6
Tamil Nadu,Thoothukkudi,JOEL. S,Marumalarchi Dravida Munnetra Kazhagam,181571,620,182191,7
Tamil Nadu,Thoothukkudi,ALWARSAMY KARTHIKEYAN.L,Independent,1725,2,1727,8
Tamil Nadu,Thoothukkudi,"ANANDHARAJ, M.",Independent,738,1,739,9
Tamil Nadu,Thoothukkudi,SANTHADEVI. S,Independent,764,1,765,10
Tamil Nadu,Thoothukkudi,SAMUEL. A.S.,Independent,1156,1,1157,11
Tamil Nadu,Thoothukkudi,PANNEERSELVAM.C,Independent,1123,6,1129,12
Tamil Nadu,Thoothukkudi,RAMKUMAR. V,Independent,783,1,784,13
Tamil Nadu,Thoothukkudi,VINSTON ANTO. S,Independent,983,0,983,14
Tamil Nadu,Thoothukkudi,None of the Above,NOTA,11413,34,11447,15
Tamil Nadu,Tenkasi ,KANNAN,Bahujan Samaj Party,2916,1,2917,1
Tamil Nadu,Tenkasi ,LINGAM.P,Communist Party of India,23479,49,23528,2
Tamil Nadu,Tenkasi ,VASANTHI.M,All India Anna Dravida Munnetra Kazhagam,424009,577,424586,3
Tamil Nadu,Tenkasi ,DR.JAYAKUMAR.K.,Indian National Congress,58835,128,58963,4
Tamil Nadu,Tenkasi ,DR.KRISHNASAMY.K.,Puthiya Tamilagam,261757,1055,262812,5
Tamil Nadu,Tenkasi ,GUNASEKARAN.K.,Tamil Nadu Makkal Congress,8019,3,8022,6
Tamil Nadu,Tenkasi ,DR.SADHAN THIRUMALAIKUMAR.T.,Marumalarchi Dravida Munnetra Kazhagam,189386,847,190233,7
Tamil Nadu,Tenkasi ,POONGANI.J.,Samata Party,1453,1,1454,8
Tamil Nadu,Tenkasi ,MEENASHISUNDARAVADIVEL.T.,Communist Party of India (Marxist),888,0,888,9
Tamil Nadu,Tenkasi ,ALAGUMALAI.V.,Independent,1215,0,1215,10
Tamil Nadu,Tenkasi ,GANESAN.S.,Independent,1809,0,1809,11
Tamil Nadu,Tenkasi ,KRISHNASAMY.A.,Independent,12114,1,12115,12
Tamil Nadu,Tenkasi ,MAGESH.S.,Independent,2163,0,2163,13
Tamil Nadu,Tenkasi ,"MANMATHAN,M.",Independent,3331,0,3331,14
Tamil Nadu,Tenkasi ,MUNEESWARAN,Independent,2512,1,2513,15
Tamil Nadu,Tenkasi ,RADHAKRISHNAN.S.,Independent,3904,0,3904,16
Tamil Nadu,Tenkasi ,VELLADURAI.P.,Independent,1216,0,1216,17
Tamil Nadu,Tenkasi ,JANAGAR RAJA,Independent,1775,2,1777,18
Tamil Nadu,Tenkasi ,None of the Above,NOTA,14470,22,14492,19
Tamil Nadu,Tirunelveli,SIVANANENTHAPERUMAL.S.,DMDK,127180,190,127370,1
Tamil Nadu,Tirunelveli,DEVADASA SUNDARAM,Dravida Munnetra Kazhagam,271474,566,272040,2
Tamil Nadu,Tirunelveli,THEVENDRAN.T.,Bahujan Samaj Party,4689,3,4692,3
Tamil Nadu,Tirunelveli,PRABAKARAN.K.R.P,All India Anna Dravida Munnetra Kazhagam,397777,362,398139,4
Tamil Nadu,Tirunelveli,RAMASUBBU.S.S,Indian National Congress,62764,99,62863,5
Tamil Nadu,Tirunelveli,SESURAJ.M.P,Aam Aadmi Party,18290,63,18353,6
Tamil Nadu,Tirunelveli,DHANARAJ.R.,ICSP,3058,4,3062,7
Tamil Nadu,Tirunelveli,DHEVANATHAN YADAV.T.,Tamil Nadu Makkal Congress,19368,13,19381,8
Tamil Nadu,Tirunelveli,MOHAMED MUBARAK.V.M.S,Social Democratic Party of India,14876,1,14877,9
Tamil Nadu,Tirunelveli,ELIZABETH.D,Independent,651,0,651,10
Tamil Nadu,Tirunelveli,DR.GANESAN.M,Independent,1262,0,1262,11
Tamil Nadu,Tirunelveli,SARAVANAN.P,Independent,740,0,740,12
Tamil Nadu,Tirunelveli,SUBRAMANIAN.K,Independent,1196,0,1196,13
Tamil Nadu,Tirunelveli,SUBRAMANIAN @ S.S.S.MANI.S,Independent,1751,0,1751,14
Tamil Nadu,Tirunelveli,SURESH KUMAR.S,Independent,1280,1,1281,15
Tamil Nadu,Tirunelveli,SELVAGANAPATHY.G,Independent,3233,0,3233,16
Tamil Nadu,Tirunelveli,DEVADOSS.A.R,Independent,3393,1,3394,17
Tamil Nadu,Tirunelveli,PATHMANABAN.K,Independent,1823,0,1823,18
Tamil Nadu,Tirunelveli,MURUGAN.S,Independent,1159,0,1159,19
Tamil Nadu,Tirunelveli,MOHAN.T,Independent,2518,0,2518,20
Tamil Nadu,Tirunelveli,RAJAMARAVAN @ MANICKAVASAGAM.S,Independent,1391,0,1391,21
Tamil Nadu,Tirunelveli,RAJI YADAV,Independent,1579,0,1579,22
Tamil Nadu,Tirunelveli,RAJESHKANNAN,Independent,947,0,947,23
Tamil Nadu,Tirunelveli,LAKSHMANAN @ LAKKAN.A,Independent,1850,0,1850,24
Tamil Nadu,Tirunelveli,VENKATESH.A,Independent,1052,0,1052,25
Tamil Nadu,Tirunelveli,VEILUMUTHUKUMAR.P,Independent,1387,0,1387,26
Tamil Nadu,Tirunelveli,GERMANUS.S,Independent,1445,1,1446,27
Tamil Nadu,Tirunelveli,None of the Above,NOTA,12880,13,12893,28
Tamil Nadu,Kanniyakumari,RADHAKRISHNAN P.,Bharatiya Janata Party,372572,334,372906,1
Tamil Nadu,Kanniyakumari,RAAJARATHINUM F.M.,Dravida Munnetra Kazhagam,117872,61,117933,2
Tamil Nadu,Kanniyakumari,BELLARMIN A.V.,Communist Party of India  (Marxist),35266,18,35284,3
Tamil Nadu,Kanniyakumari,VASANTHA KUMAR H.,Indian National Congress,244099,145,244244,4
Tamil Nadu,Kanniyakumari,JAWAHAR J.,Bahujan Samaj Party,3236,0,3236,5
Tamil Nadu,Kanniyakumari,JOHN THANKAM D.,All India Anna Dravida Munnetra Kazhagam,176182,57,176239,6
Tamil Nadu,Kanniyakumari,ANTHONY MUTHU,Communist Party of India (Marxist-Lenninist) (Liberation),1647,0,1647,7
Tamil Nadu,Kanniyakumari,UDAYAKUMAR S.P.,Aam Aadmi Party,15305,9,15314,8
Tamil Nadu,Kanniyakumari,PAULRAJ C.M.,Communist Party of India (Marxist),436,0,436,9
Tamil Nadu,Kanniyakumari,SHALIN RICHARD J.,IVP,398,0,398,10
Tamil Nadu,Kanniyakumari,RADHAKRISHNAN T.,Independent,534,0,534,11
Tamil Nadu,Kanniyakumari,KAMARAJ K.,Independent,955,0,955,12
Tamil Nadu,Kanniyakumari,KAMARAJ G.,Independent,591,0,591,13
Tamil Nadu,Kanniyakumari,SARASWATHI S.,Independent,536,0,536,14
Tamil Nadu,Kanniyakumari,SEETHARAMADHAS P.,Independent,930,0,930,15
Tamil Nadu,Kanniyakumari,NALLA THAMPY C.,Independent,2391,0,2391,16
Tamil Nadu,Kanniyakumari,NAGOOR MEERAN PEER MOHAMEAD U.,Independent,3851,0,3851,17
Tamil Nadu,Kanniyakumari,PADMANABHAN S.,Independent,1246,0,1246,18
Tamil Nadu,Kanniyakumari,BALA SUBRAMANIAN T.,Independent,1737,0,1737,19
Tamil Nadu,Kanniyakumari,MANIKANDAN I.,Independent,1557,0,1557,20
Tamil Nadu,Kanniyakumari,RAJESH KUMAR K.R.,Independent,1437,0,1437,21
Tamil Nadu,Kanniyakumari,VASANTHA KUMAR L.,Independent,1474,0,1474,22
Tamil Nadu,Kanniyakumari,VASANTHEESVARAN E.,Independent,791,0,791,23
Tamil Nadu,Kanniyakumari,WILSON I.,Independent,421,0,421,24
Tamil Nadu,Kanniyakumari,JOSE BILBIN J.,Independent,504,0,504,25
Tamil Nadu,Kanniyakumari,None of the Above,NOTA,4146,4,4150,26
Tripura,Tripura West,ARUNODAY SAHA,Indian National Congress,167226,953,168179,1
Tripura,Tripura West,SANKAR PRASAD DATTA,Communist Party of India  (Marxist),667086,4579,671665,2
Tripura,Tripura West,SUDHINDRA CHANDRA DASGUPTA,Bharatiya Janata Party,54406,300,54706,3
Tripura,Tripura West,ARUN KUMAR BHOWMIK,SOCIALIST UNITY CENTRE OF INDIA (COMMUNIST),8150,52,8202,4
Tripura,Tripura West,PARTHA KARMAKAR,Communist Party of India (Marxist-Lenninist) (Liberation),4196,30,4226,5
Tripura,Tripura West,PJECH DEBBARMA,Jai Maha Bharath Party,2004,57,2061,6
Tripura,Tripura West,BINAY DEBBARMA,IPFT,10889,151,11040,7
Tripura,Tripura West,RATAN CHAKRABORTI,All India Trinamool Congress,115618,2109,117727,8
Tripura,Tripura West,RAKHAL RAJ DATTA,Amra Bangalee,2805,74,2879,9
Tripura,Tripura West,SALIL SAHA,Aam Aadmi Party,4894,87,4981,10
Tripura,Tripura West,SUBAL BHOWMIK,Tripura Pragatishil Gramin Congress,4579,111,4690,11
Tripura,Tripura West,KAMAL KANTI DEBNATH,Independent,3729,18,3747,12
Tripura,Tripura West,JOGANATI DATTA,Independent,5932,15,5947,13
Tripura,Tripura West,None of the Above,NOTA,12590,109,12699,14
Tripura,Tripura East,JITENDRA CHAUDHURY,Communist Party of India  (Marxist),620251,3520,623771,1
Tripura,Tripura East,PARIKSHIT DEBBARMA,Bharatiya Janata Party,60245,368,60613,2
Tripura,Tripura East,SACHITRA DEBBARMA,Indian National Congress,138743,670,139413,3
Tripura,Tripura East,KARNA BIJOY JAMATIA,Aam Aadmi Party,4800,71,4871,4
Tripura,Tripura East,NARENDRA CHANDRA DEB BARMA,IPFT,10219,67,10286,5
Tripura,Tripura East,FALGUNI TRIPURA,Communist Party of India (Marxist-Lenninist) (Liberation),4396,48,4444,6
Tripura,Tripura East,BASU MOG,Tripura Pragatishil Gramin Congress,4211,51,4262,7
Tripura,Tripura East,BIKASH DEBBARMA,Jai Maha Bharath Party,3030,56,3086,8
Tripura,Tripura East,BHRIGURAM REANG,All India Trinamool Congress,75669,1359,77028,9
Tripura,Tripura East,SUBARNA MALA DEBBARMA,Amra Bangalee,4116,36,4152,10
Tripura,Tripura East,PATAL KANYA JAMATIA,Independent,2983,21,3004,11
Tripura,Tripura East,PRABIDDHA REANG,Independent,5036,30,5066,12
Tripura,Tripura East,None of the Above,NOTA,11003,81,11084,13
Uttar Pradesh,Saharanpur,IMRAN MASOOD,Indian National Congress,407816,93,407909,1
Uttar Pradesh,Saharanpur,JAGDISH SINGH RANA,Bahujan Samaj Party,234699,334,235033,2
Uttar Pradesh,Saharanpur,RAGHAV LAKHANPAL,Bharatiya Janata Party,472261,738,472999,3
Uttar Pradesh,Saharanpur,SHAZAN MASOOD URF SHADAN MASOOD,Samajwadi Party,52736,29,52765,4
Uttar Pradesh,Saharanpur,YOGESH KUMAR,Aam Aadmi Party,3055,10,3065,5
Uttar Pradesh,Saharanpur,RATAN SINGH,Bahujan Mukti Party,1363,3,1366,6
Uttar Pradesh,Saharanpur,RAJENDER KUMAR,ARVP,466,0,466,7
Uttar Pradesh,Saharanpur,SHAHANAVAJ,RJ,553,0,553,8
Uttar Pradesh,Saharanpur,SHIV KUMAR,Ambedkar Samaj Party,1885,3,1888,9
Uttar Pradesh,Saharanpur,MOHD. FIROZ AFTAB,Independent,692,0,692,10
Uttar Pradesh,Saharanpur,RAGHUVEER SINGH BODH,Independent,1064,2,1066,11
Uttar Pradesh,Saharanpur,CP VERMA,Independent,2112,2,2114,12
Uttar Pradesh,Saharanpur,SESHRAJ,Independent,4056,1,4057,13
Uttar Pradesh,Saharanpur,HANSRAJ SAINI,Independent,4068,0,4068,14
Uttar Pradesh,Saharanpur,None of the Above,NOTA,6260,7,6267,15
Uttar Pradesh,Kairana,KARTAR SINGH BHADANA,Rashtriya Lok Dal,42657,49,42706,1
Uttar Pradesh,Kairana,KANWAR HASAN,Bahujan Samaj Party,160262,152,160414,2
Uttar Pradesh,Kairana,NAHID HASAN,Samajwadi Party,329013,68,329081,3
Uttar Pradesh,Kairana,HUKUM SINGH,Bharatiya Janata Party,565071,838,565909,4
Uttar Pradesh,Kairana,DIVAKAR KASHYAP,All India Trinamool Congress,6562,0,6562,5
Uttar Pradesh,Kairana,PARDIP,Bahujan Mukti Party,1047,3,1050,6
Uttar Pradesh,Kairana,RAMKARAN KASHYAP,BaVaP,1375,1,1376,7
Uttar Pradesh,Kairana,SUNITA,Janata Dal (United),949,0,949,8
Uttar Pradesh,Kairana,SUNIL KUMAR KASANA,Aam Aadmi Party,2653,9,2662,9
Uttar Pradesh,Kairana,KRISHANPAL,Independent,2968,3,2971,10
Uttar Pradesh,Kairana,MOHANLAL,Independent,1741,0,1741,11
Uttar Pradesh,Kairana,None of the Above,NOTA,3901,2,3903,12
Uttar Pradesh,Muzaffarnagar,KADIR RANA,Bahujan Samaj Party,251528,713,252241,1
Uttar Pradesh,Muzaffarnagar,PANKAJ AGARWAL,Indian National Congress,12746,191,12937,2
Uttar Pradesh,Muzaffarnagar,VIRENDER SINGH,Samajwadi Party,160532,278,160810,3
Uttar Pradesh,Muzaffarnagar,(DR.) SANJEEV KUMAR BALYAN,Bharatiya Janata Party,649938,3453,653391,4
Uttar Pradesh,Muzaffarnagar,ANIL KUMAR,Bahujan Mukti Party,2222,16,2238,5
Uttar Pradesh,Muzaffarnagar,CHATAR SINGH KASHYAP,Vanchit Jamat Party,350,0,350,6
Uttar Pradesh,Muzaffarnagar,MANGE RAM KASHYAP,MKUP,359,1,360,7
Uttar Pradesh,Muzaffarnagar,MOHAMMED YAMIN,Aam Aadmi Party,1912,21,1933,8
Uttar Pradesh,Muzaffarnagar,MO. YAMIN,AIRSP,542,1,543,9
Uttar Pradesh,Muzaffarnagar,RAJESH DEVI ALIAS RADHIKA BALIYAN,All India Trinamool Congress,4127,2,4129,10
Uttar Pradesh,Muzaffarnagar,LALIT CHAUHAN,Janata Dal (United),496,3,499,11
Uttar Pradesh,Muzaffarnagar,ANKUR,Independent,719,4,723,12
Uttar Pradesh,Muzaffarnagar,GUFRAN AHMAD,Independent,1680,2,1682,13
Uttar Pradesh,Muzaffarnagar,JAGBIR SINGH,Independent,838,7,845,14
Uttar Pradesh,Muzaffarnagar,NASEEM AHMAD ANSARI,Independent,750,0,750,15
Uttar Pradesh,Muzaffarnagar,PHOOL SINGH PAL,Independent,3426,5,3431,16
Uttar Pradesh,Muzaffarnagar,RAKESH,Independent,3482,0,3482,17
Uttar Pradesh,Muzaffarnagar,SHABNAM,Independent,485,2,487,18
Uttar Pradesh,Muzaffarnagar,SHANDAR GUFRAN,Independent,1864,0,1864,19
Uttar Pradesh,Muzaffarnagar,None of the Above,NOTA,4717,22,4739,20
Uttar Pradesh,Bijnor,JAYA PRADA NAHATA,Rashtriya Lok Dal,24257,91,24348,1
Uttar Pradesh,Bijnor,KUNWAR BHARTENDRA,Bharatiya Janata Party,485625,1288,486913,2
Uttar Pradesh,Bijnor,MALOOK NAGAR,Bahujan Samaj Party,229683,441,230124,3
Uttar Pradesh,Bijnor,SHAHNAWAZ RANA,Samajwadi Party,280957,182,281139,4
Uttar Pradesh,Bijnor,UDAY ALIES UDAYVEER,Bharatiya Momin Front,2455,1,2456,5
Uttar Pradesh,Bijnor,GAURAV,Aam Aadmi Party,2474,9,2483,6
Uttar Pradesh,Bijnor,PARVEZ AQIL,All India Minorities Front,721,1,722,7
Uttar Pradesh,Bijnor,MOHAMAD ADEEB,Rashtrawadi Samaj Party,1754,2,1756,8
Uttar Pradesh,Bijnor,MOHAMMAD MOOSA,Peace Party,15799,2,15801,9
Uttar Pradesh,Bijnor,UMESH ALIES PANI,Independent,2963,4,2967,10
Uttar Pradesh,Bijnor,KAMAL,Independent,2411,134,2545,11
Uttar Pradesh,Bijnor,GAJRESH KUMAR,Independent,3317,0,3317,12
Uttar Pradesh,Bijnor,None of the Above,NOTA,5754,21,5775,13
Uttar Pradesh,Nagina,GIRISH CHANDRA,Bahujan Samaj Party,245627,58,245685,1
Uttar Pradesh,Nagina,YASHWANT SINGH,Bharatiya Janata Party,367683,142,367825,2
Uttar Pradesh,Nagina,YASHVIR SINGH,Samajwadi Party,275400,35,275435,3
Uttar Pradesh,Nagina,OMPRAKASH RAVI,Shivsena,2967,0,2967,4
Uttar Pradesh,Nagina,TEJ SINGH,Ambedkar Samaj Party,1845,0,1845,5
Uttar Pradesh,Nagina,BHAGWAN DASS RATHOR,MD,4581,0,4581,6
Uttar Pradesh,Nagina,MANJU DEVI,Lok Dal,1027,0,1027,7
Uttar Pradesh,Nagina,VINOD KUMAR,Bahujan Mukti Party,852,0,852,8
Uttar Pradesh,Nagina,SHARISHTHA KUMAR SINGH,Jai Maha Bharath Party,861,0,861,9
Uttar Pradesh,Nagina,SHEESHRAM SINGH RAVI,Peace Party,21333,1,21334,10
Uttar Pradesh,Nagina,SARIKA,Aam Aadmi Party,3692,3,3695,11
Uttar Pradesh,Nagina,ASARPAT SINGH,Independent,1714,0,1714,12
Uttar Pradesh,Nagina,SHAMSHER,Independent,3577,0,3577,13
Uttar Pradesh,Nagina,SUNIL,Independent,4328,0,4328,14
Uttar Pradesh,Nagina,None of the Above,NOTA,6470,0,6470,15
Uttar Pradesh,Moradabad,NAFISUDDIN,Communist Party of India  (Marxist),3177,3,3180,1
Uttar Pradesh,Moradabad,BEGUM NOOR BANO URF MEHTAB,Indian National Congress,19663,69,19732,2
Uttar Pradesh,Moradabad,HAJI MOHD YAQOOB,Bahujan Samaj Party,160650,295,160945,3
Uttar Pradesh,Moradabad,KUNWER SARVESH KUMAR,Bharatiya Janata Party,484023,1201,485224,4
Uttar Pradesh,Moradabad,DR S T HASAN,Samajwadi Party,397482,238,397720,5
Uttar Pradesh,Moradabad,AMIT KUMAR,Bahujan Mukti Party,3041,6,3047,6
Uttar Pradesh,Moradabad,KAMAR ALAM,Indian Bahujan Smajwadi Party,1058,1,1059,7
Uttar Pradesh,Moradabad,JAIPAL SINGH SAINI,Shivsena,1332,2,1334,8
Uttar Pradesh,Moradabad,MOHD ZAFAR IQBAL,ABML(S),956,0,956,9
Uttar Pradesh,Moradabad,TEAJ SINGH SAINI,Rashtriya Samanta Dal,1710,0,1710,10
Uttar Pradesh,Moradabad,ENGINEER MOHAMMAD IRFAN,Peace Party,25830,10,25840,11
Uttar Pradesh,Moradabad,VIMAL KUMAR,Aam Aadmi Party,4444,25,4469,12
Uttar Pradesh,Moradabad,SATISH CHANDRA SHARMA,NAP,2267,0,2267,13
Uttar Pradesh,Moradabad,SANDEEP KUMAR,SSKP,2971,0,2971,14
Uttar Pradesh,Moradabad,SAURABH PRATAP SINGH,All India Trinamool Congress,5642,5,5647,15
Uttar Pradesh,Moradabad,HARIOM,NADP,4095,2,4097,16
Uttar Pradesh,Moradabad,RAJ KUMAR GUPTA,Independent,1277,1,1278,17
Uttar Pradesh,Moradabad,ROOPA CHANDRA SINGH,Independent,1281,1,1282,18
Uttar Pradesh,Moradabad,None of the Above,NOTA,5193,14,5207,19
Uttar Pradesh,Rampur,AKBAR HUSAIN,Bahujan Samaj Party,81004,2,81006,1
Uttar Pradesh,Rampur,NAWAB KAZIM ALI KHAN,Indian National Congress,156466,0,156466,2
Uttar Pradesh,Rampur,NASEER AHMAD KHAN,Samajwadi Party,335179,2,335181,3
Uttar Pradesh,Rampur,DR. NEPAL SINGH,Bharatiya Janata Party,358590,26,358616,4
Uttar Pradesh,Rampur,JANNAT NISHA,All India Minorities Front,4473,0,4473,5
Uttar Pradesh,Rampur,VIJENDRA SINGH,RAC,2079,0,2079,6
Uttar Pradesh,Rampur,SYED SALMAN ALI,Aam Aadmi Party,1996,0,1996,7
Uttar Pradesh,Rampur,AKBAR MASOOD,Independent,817,0,817,8
Uttar Pradesh,Rampur,JAGDISH SARAN SAGAR,Independent,1834,0,1834,9
Uttar Pradesh,Rampur,JAGMOHAN,Independent,2505,0,2505,10
Uttar Pradesh,Rampur,TEJPAL SINGH,Independent,2063,0,2063,11
Uttar Pradesh,Rampur,NAVED MIAN,Independent,2448,0,2448,12
Uttar Pradesh,Rampur,None of the Above,NOTA,6905,0,6905,13
Uttar Pradesh,Sambhal,AQEEL-UR -REHMAN KHAN,Bahujan Samaj Party,252370,270,252640,1
Uttar Pradesh,Sambhal,ACHARYA PRAMOD KRISHNAM,Indian National Congress,16016,18,16034,2
Uttar Pradesh,Sambhal,DR SHAFIQ- UR RAHMAN BARQ,Samajwadi Party,354774,294,355068,3
Uttar Pradesh,Sambhal,SATYAPAL SINGH,Bharatiya Janata Party,359678,564,360242,4
Uttar Pradesh,Sambhal,MOHD ASLAM URF PASHA,Republican Party of India (A),3833,0,3833,5
Uttar Pradesh,Sambhal,DHARAM YADAV URF D.P.YADAV,Rashtriya Parivartan Dal,36110,24,36134,6
Uttar Pradesh,Sambhal,DR. RASHID ALI,Peace Party,6373,3,6376,7
Uttar Pradesh,Sambhal,REKHA DEVI YADAV,SSAD,1562,3,1565,8
Uttar Pradesh,Sambhal,AQEEL AHMAD,Independent,2003,2,2005,9
Uttar Pradesh,Sambhal,NANAD RAM KHADAGVANSHI,Independent,2322,0,2322,10
Uttar Pradesh,Sambhal,NUTAN VIJAY ADVOCATE,Independent,6686,0,6686,11
Uttar Pradesh,Sambhal,FIROZ HAIDER,Independent,3645,3,3648,12
Uttar Pradesh,Sambhal,RASHID,Independent,2791,0,2791,13
Uttar Pradesh,Sambhal,None of the Above,NOTA,7654,4,7658,14
Uttar Pradesh,Amroha,KANWAR SINGH TANWAR,Bharatiya Janata Party,528796,84,528880,1
Uttar Pradesh,Amroha,FARHAT HASAN,Bahujan Samaj Party,162962,21,162983,2
Uttar Pradesh,Amroha,RAKESH TIKAIT,Rashtriya Lok Dal,9537,2,9539,3
Uttar Pradesh,Amroha,HUMERA AKHTAR,Samajwadi Party,370646,20,370666,4
Uttar Pradesh,Amroha,KHAJAN SINGH,RAC,2448,0,2448,5
Uttar Pradesh,Amroha,BRAJLAL,Bahujan Mukti Party,837,0,837,6
Uttar Pradesh,Amroha,MAHESH,Republican Party of India (A),713,0,713,7
Uttar Pradesh,Amroha,RAKESH,Peace Party,749,0,749,8
Uttar Pradesh,Amroha,RAJPAL,ARVP,478,0,478,9
Uttar Pradesh,Amroha,SARVESH KUMAR SAINI,Shivsena,980,0,980,10
Uttar Pradesh,Amroha,SYED KALBE RUSHAID RIZVI,Aam Aadmi Party,2600,1,2601,11
Uttar Pradesh,Amroha,HUSNEIN RAZAA,aicp,857,1,858,12
Uttar Pradesh,Amroha,NARESH KUMAR,Independent,2493,0,2493,13
Uttar Pradesh,Amroha,NARESH CHAND,Independent,1431,0,1431,14
Uttar Pradesh,Amroha,SURENDRA SINGH,Independent,2425,0,2425,15
Uttar Pradesh,Amroha,None of the Above,NOTA,7779,0,7779,16
Uttar Pradesh,Meerut,NAGMA,Indian National Congress,42799,112,42911,1
Uttar Pradesh,Meerut,RAJENDRA AGARWAL,Bharatiya Janata Party,531898,1083,532981,2
Uttar Pradesh,Meerut,MOHD.SHAHID AKHLAK,Bahujan Samaj Party,300267,388,300655,3
Uttar Pradesh,Meerut,SHAHID MANZOOR,Samajwadi Party,211573,186,211759,4
Uttar Pradesh,Meerut,MOHD.USMAN GHAZI,RsAD,1451,0,1451,5
Uttar Pradesh,Meerut,MOHD. SAJID SAIFI,Bahujan Mukti Party,1052,11,1063,6
Uttar Pradesh,Meerut,DR. (EX. MAJ) HIMANSHU SINGH,Aam Aadmi Party,11742,51,11793,7
Uttar Pradesh,Meerut,ATUL KHODAWAL,Independent,818,0,818,8
Uttar Pradesh,Meerut,ANIL,Independent,348,0,348,9
Uttar Pradesh,Meerut,APHAJAL,Independent,382,0,382,10
Uttar Pradesh,Meerut,IQRA CHOUDHARY,Independent,734,0,734,11
Uttar Pradesh,Meerut,MUKESH KUMAR,Independent,1542,0,1542,12
Uttar Pradesh,Meerut,SUNIL DUTT,Independent,1734,0,1734,13
Uttar Pradesh,Meerut,None of the Above,NOTA,5202,11,5213,14
Uttar Pradesh,Baghpat,AJIT SINGH,Rashtriya Lok Dal,199368,148,199516,1
Uttar Pradesh,Baghpat,GHULAM MOHAMMED,Samajwadi Party,213557,52,213609,2
Uttar Pradesh,Baghpat,PRASHANT CHAUDHRI,Bahujan Samaj Party,141672,71,141743,3
Uttar Pradesh,Baghpat,DR. SATYA PAL SINGH,Bharatiya Janata Party,423108,367,423475,4
Uttar Pradesh,Baghpat,ANIL KUMAR,Peace Party,3024,1,3025,5
Uttar Pradesh,Baghpat,KRISHAN PAL,NAP,601,0,601,6
Uttar Pradesh,Baghpat,YUNUSH,NNP,441,0,441,7
Uttar Pradesh,Baghpat,SOMENDAR DHAKA,Aam Aadmi Party,5816,12,5828,8
Uttar Pradesh,Baghpat,AJAY PAL,Independent,440,0,440,9
Uttar Pradesh,Baghpat,ARVIND,Independent,992,0,992,10
Uttar Pradesh,Baghpat,JAIVINDRA KUMAR,Independent,3915,0,3915,11
Uttar Pradesh,Baghpat,NISHANT,Independent,2707,1,2708,12
Uttar Pradesh,Baghpat,RUKSANA,Independent,2092,0,2092,13
Uttar Pradesh,Baghpat,SUBHASH CHAND KASHYAP,Independent,1967,0,1967,14
Uttar Pradesh,Baghpat,None of the Above,NOTA,3911,0,3911,15
Uttar Pradesh,Ghaziabad,MUKUL,Bahujan Samaj Party,173042,43,173085,1
Uttar Pradesh,Ghaziabad,RAJ BABBAR,Indian National Congress,191188,34,191222,2
Uttar Pradesh,Ghaziabad,VIJAY KUMAR SINGH,Bharatiya Janata Party,758113,369,758482,3
Uttar Pradesh,Ghaziabad,SUDHAN KUMAR,Samajwadi Party,106956,28,106984,4
Uttar Pradesh,Ghaziabad,NARESH GAUTAM,Bahujan Mukti Party,1545,3,1548,5
Uttar Pradesh,Ghaziabad,SHAZIA ILMI MALIK,Aam Aadmi Party,89125,22,89147,6
Uttar Pradesh,Ghaziabad,SURESH PAL,BSKP,1591,0,1591,7
Uttar Pradesh,Ghaziabad,KESHAV CHOUDHARY,Independent,628,0,628,8
Uttar Pradesh,Ghaziabad,NITIN,Independent,623,1,624,9
Uttar Pradesh,Ghaziabad,RAMPHAL SHAKYA,Independent,1093,1,1094,10
Uttar Pradesh,Ghaziabad,RINKU KUMAR TYAGI,Independent,1185,0,1185,11
Uttar Pradesh,Ghaziabad,VINOD KUMAR TYAGI,Independent,992,0,992,12
Uttar Pradesh,Ghaziabad,SALEEM MALIK,Independent,1486,0,1486,13
Uttar Pradesh,Ghaziabad,SABIR,Independent,3409,0,3409,14
Uttar Pradesh,Ghaziabad,SANJEEV KUMAR,Independent,4639,0,4639,15
Uttar Pradesh,Ghaziabad,None of the Above,NOTA,6203,2,6205,16
Uttar Pradesh,Gautam Buddha Nagar,NARENDRA BHATI,Samajwadi Party,319349,141,319490,1
Uttar Pradesh,Gautam Buddha Nagar,DR.MAHESH  SHARMA,Bharatiya Janata Party,599174,528,599702,2
Uttar Pradesh,Gautam Buddha Nagar,RAMESH CHAND TOMAR,Indian National Congress,12708,19,12727,3
Uttar Pradesh,Gautam Buddha Nagar,SATISH KUMAR,Bahujan Samaj Party,198077,160,198237,4
Uttar Pradesh,Gautam Buddha Nagar,UDAYVEER,RtrJP,1526,0,1526,5
Uttar Pradesh,Gautam Buddha Nagar,KISHAN PAL SINGH,Aam Aadmi Party,32348,10,32358,6
Uttar Pradesh,Gautam Buddha Nagar,GAJENDRA,IOP,649,0,649,7
Uttar Pradesh,Gautam Buddha Nagar,DHARMENDER,DND,4130,0,4130,8
Uttar Pradesh,Gautam Buddha Nagar,RAVINDER SHARMA,Rashtriya Kranti Party,503,0,503,9
Uttar Pradesh,Gautam Buddha Nagar,RAM VILAS,Bahujan Mukti Party,655,1,656,10
Uttar Pradesh,Gautam Buddha Nagar,RUVEZ ALAM RAHI,National Loktantrik Party,773,0,773,11
Uttar Pradesh,Gautam Buddha Nagar,MOHD. SABIR ANSARI,All India Trinamool Congress,4506,0,4506,12
Uttar Pradesh,Gautam Buddha Nagar,LT COL SP SINGH,NBDP,1183,0,1183,13
Uttar Pradesh,Gautam Buddha Nagar,SEEMA,Rashtriya Naujawan Dal,974,3,977,14
Uttar Pradesh,Gautam Buddha Nagar,SONIA SHARMA,ABSC,2528,2,2530,15
Uttar Pradesh,Gautam Buddha Nagar,KADEEM,Independent,4198,0,4198,16
Uttar Pradesh,Gautam Buddha Nagar,KADIR KHAN JAISWAL,Independent,2684,0,2684,17
Uttar Pradesh,Gautam Buddha Nagar,GRISA KUMAR,Independent,3496,0,3496,18
Uttar Pradesh,Gautam Buddha Nagar,MAHESH,Independent,785,3,788,19
Uttar Pradesh,Gautam Buddha Nagar,RAKESH,Independent,1225,0,1225,20
Uttar Pradesh,Gautam Buddha Nagar,SAFRUDDIN,Independent,491,0,491,21
Uttar Pradesh,Gautam Buddha Nagar,SAVITRI,Independent,996,0,996,22
Uttar Pradesh,Gautam Buddha Nagar,SUNIL GAUTAM,Independent,622,1,623,23
Uttar Pradesh,Gautam Buddha Nagar,SUMITI,Independent,978,0,978,24
Uttar Pradesh,Gautam Buddha Nagar,None of the Above,NOTA,3836,0,3836,25
Uttar Pradesh,Bulandshahr,ANJU URF MUSKAN,Rashtriya Lok Dal,59088,28,59116,1
Uttar Pradesh,Bulandshahr,KAMLESH,Samajwadi Party,128646,91,128737,2
Uttar Pradesh,Bulandshahr,PRADEEP KUMAR JATAV,Bahujan Samaj Party,182268,208,182476,3
Uttar Pradesh,Bulandshahr,BHOLA SINGH,Bharatiya Janata Party,603860,589,604449,4
Uttar Pradesh,Bulandshahr,PYARE LAL,Bahujan Mukti Party,4444,4,4448,5
Uttar Pradesh,Bulandshahr,RAGHURAJ PRATAP SINGH,Rashtriya Kranti Party,1455,0,1455,6
Uttar Pradesh,Bulandshahr,DR. RAHUL DIPANKAR,Aam Aadmi Party,9702,25,9727,7
Uttar Pradesh,Bulandshahr,VIJAI PAL,RtJP,4116,1,4117,8
Uttar Pradesh,Bulandshahr,SURESH,Jai Maha Bharath Party,2579,1,2580,9
Uttar Pradesh,Bulandshahr,HARVIR,Independent,5689,1,5690,10
Uttar Pradesh,Bulandshahr,None of the Above,NOTA,6909,6,6915,11
Uttar Pradesh,Aligarh,DR. ARVIND KUMAR SINGH,Bahujan Samaj Party,227884,2,227886,1
Uttar Pradesh,Aligarh,ZAFAR ALAM,Samajwadi Party,226284,0,226284,2
Uttar Pradesh,Aligarh,BIJENDRA SINGH,Indian National Congress,62674,0,62674,3
Uttar Pradesh,Aligarh,SATISH KUMAR,Bharatiya Janata Party,514554,68,514622,4
Uttar Pradesh,Aligarh,AMITA SINGH JAT,SSKP,3376,0,3376,5
Uttar Pradesh,Aligarh,DURGESH CHANDRA GAUTAM,All India Trinamool Congress,3076,0,3076,6
Uttar Pradesh,Aligarh,DEVANAND,Lok Dal,785,0,785,7
Uttar Pradesh,Aligarh,PRADEEP KUMAR,Bahujan Mukti Party,626,0,626,8
Uttar Pradesh,Aligarh,BADSHAH,Peace Party,978,0,978,9
Uttar Pradesh,Aligarh,RAKESH CHANDRA RAWAT,Rashtriya Sawarn Dal,665,0,665,10
Uttar Pradesh,Aligarh,VINOD KUMAR BAGHEL,RSPS,1723,0,1723,11
Uttar Pradesh,Aligarh,MOHD. SABIR RAHI,Aam Aadmi Party,8977,1,8978,12
Uttar Pradesh,Aligarh,NATTHI LAL SHARMA,Independent,4659,0,4659,13
Uttar Pradesh,Aligarh,SANJAY KUMAR,Independent,1842,0,1842,14
Uttar Pradesh,Aligarh,None of the Above,NOTA,6183,0,6183,15
Uttar Pradesh,Hathras,NIRANJAN SINGH DHANGAR,Rashtriya Lok Dal,86108,1,86109,1
Uttar Pradesh,Hathras,MANOJ KUMAR SONI,Bahujan Samaj Party,217887,4,217891,2
Uttar Pradesh,Hathras,RAJESH KUMAR DIWAKER,Bharatiya Janata Party,544252,25,544277,3
Uttar Pradesh,Hathras,RAMJI LAL SUMAN,Samajwadi Party,180889,2,180891,4
Uttar Pradesh,Hathras,SUNHARI LAL,Aam Aadmi Party,5042,1,5043,5
Uttar Pradesh,Hathras,OMPRKASH,Independent,2778,0,2778,6
Uttar Pradesh,Hathras,DALVIR SINGH,Independent,1599,0,1599,7
Uttar Pradesh,Hathras,NIRANJAN SINGH,Independent,2847,0,2847,8
Uttar Pradesh,Hathras,RAJA RAM,Independent,2169,0,2169,9
Uttar Pradesh,Hathras,None of the Above,NOTA,5669,0,5669,10
Uttar Pradesh,Mathura,CHANDAN SINGH,Samajwadi Party,36672,1,36673,1
Uttar Pradesh,Mathura,JAYANT CHAUDHARY,Rashtriya Lok Dal,243884,6,243890,2
Uttar Pradesh,Mathura,PT. YOGESH KUMAR DWIVEDI,Bahujan Samaj Party,173570,2,173572,3
Uttar Pradesh,Mathura,HEMA MALINI,Bharatiya Janata Party,574451,182,574633,4
Uttar Pradesh,Mathura,ANUJ KUMAR GARG,Aam Aadmi Party,7855,3,7858,5
Uttar Pradesh,Mathura,PT. UDYAN SHARMA ''''''''MUNNA'''''''',Peace Party,1066,0,1066,6
Uttar Pradesh,Mathura,PARSOTTAM,Rashtriya Mahan Gantantra Party,1338,0,1338,7
Uttar Pradesh,Mathura,BHUPENDRA KUMAR  DHANGAR,RSOSP,1054,0,1054,8
Uttar Pradesh,Mathura,MAHARAM SINGH,Bahujan Mukti Party,655,0,655,9
Uttar Pradesh,Mathura,MAHESH PRATAP SHARMA,Rashtriya Vikas Party,2396,0,2396,10
Uttar Pradesh,Mathura,MOHAN SHYAM,GaAP,731,0,731,11
Uttar Pradesh,Mathura,THAKUR HEMENDRA VEER SINGH,SSKP,1858,0,1858,12
Uttar Pradesh,Mathura,OM PRAKASH,Independent,2847,0,2847,13
Uttar Pradesh,Mathura,PRAMOD KRISHNA,Independent,1759,0,1759,14
Uttar Pradesh,Mathura,FAKKAR BABA ''''''''RAMAYANI'''''''',Independent,2160,0,2160,15
Uttar Pradesh,Mathura,BHUDEV,Independent,2715,0,2715,16
Uttar Pradesh,Mathura,RADHACHARAN,Independent,4795,0,4795,17
Uttar Pradesh,Mathura,RAM BABU SAINI,Independent,2082,0,2082,18
Uttar Pradesh,Mathura,SATISH CHANDRA SHARMA,Independent,2675,0,2675,19
Uttar Pradesh,Mathura,HEMA MALINI,Independent,10158,0,10158,20
Uttar Pradesh,Mathura,None of the Above,NOTA,1953,0,1953,21
Uttar Pradesh,Agra,UPENDRA SINGH,Indian National Congress,34795,39,34834,1
Uttar Pradesh,Agra,NARAYAN SINGH SUMAN,Bahujan Samaj Party,283261,192,283453,2
Uttar Pradesh,Agra,MAHARAJ SINGH DHANGAR,Samajwadi Party,134650,58,134708,3
Uttar Pradesh,Agra,DR. RAM SHANKAR KATHERIA,Bharatiya Janata Party,583141,575,583716,4
Uttar Pradesh,Agra,ANIL,BKPP,3645,1,3646,5
Uttar Pradesh,Agra,ANITA,Vanchitsamaj Insaaf Party,765,0,765,6
Uttar Pradesh,Agra,CHANDRA PAL,A S P,557,0,557,7
Uttar Pradesh,Agra,PREM SINGH,Bahujan Mukti Party,770,1,771,8
Uttar Pradesh,Agra,RAMESH,Janata Dal (United),602,0,602,9
Uttar Pradesh,Agra,RAVINDRA SINGH,Aam Aadmi Party,7785,19,7804,10
Uttar Pradesh,Agra,AMAR SINGH,Independent,2450,3,2453,11
Uttar Pradesh,Agra,ASHOK KUMAR,Independent,1416,0,1416,12
Uttar Pradesh,Agra,OM PRAKASH,Independent,4242,1,4243,13
Uttar Pradesh,Agra,DINESH KUMAR GAUTAM,Independent,3656,1,3657,14
Uttar Pradesh,Agra,VINOD KUMAR SINGH,Independent,2583,1,2584,15
Uttar Pradesh,Agra,None of the Above,NOTA,5185,6,5191,16
Uttar Pradesh,Fatehpur Sikri,AMAR SINGH,Rashtriya Lok Dal,24148,37,24185,1
Uttar Pradesh,Fatehpur Sikri,BABULAL,Bharatiya Janata Party,426189,400,426589,2
Uttar Pradesh,Fatehpur Sikri,RANI PAKSHALIKA SINGH,Samajwadi Party,213255,142,213397,3
Uttar Pradesh,Fatehpur Sikri,SEEMA UPADHYAY,Bahujan Samaj Party,253262,221,253483,4
Uttar Pradesh,Fatehpur Sikri,ASHOK KUMAR,GaAP,2551,2,2553,5
Uttar Pradesh,Fatehpur Sikri,PEETAM SINGH,Rashtriya Kranti Party,871,1,872,6
Uttar Pradesh,Fatehpur Sikri,PITAM SINGH,Janata Dal (United),691,0,691,7
Uttar Pradesh,Fatehpur Sikri,PANKAJ KUMAR SHARMA,Rashtriya Samanta Dal,2052,0,2052,8
Uttar Pradesh,Fatehpur Sikri,MANIK,Lok Dal,643,0,643,9
Uttar Pradesh,Fatehpur Sikri,MUNNA LAL,Rashtriya Mahan Gantantra Party,497,0,497,10
Uttar Pradesh,Fatehpur Sikri,MEGH SINGH,Peace Party,1529,0,1529,11
Uttar Pradesh,Fatehpur Sikri,ROHAN SINGH,Bahujan Mukti Party,1061,2,1063,12
Uttar Pradesh,Fatehpur Sikri,LAXMI,Aam Aadmi Party,3114,3,3117,13
Uttar Pradesh,Fatehpur Sikri,VIJAY SINGH KUSHWAHA,SSAD,5222,1,5223,14
Uttar Pradesh,Fatehpur Sikri,ANIL KUMAR,Independent,3809,0,3809,15
Uttar Pradesh,Fatehpur Sikri,AMBEDKARI HASNURAM AMBEDKARI,Independent,3512,0,3512,16
Uttar Pradesh,Fatehpur Sikri,KHEMRAJ SINGH,Independent,951,0,951,17
Uttar Pradesh,Fatehpur Sikri,DIWAN SINGH,Independent,3101,0,3101,18
Uttar Pradesh,Fatehpur Sikri,NATHOLI,Independent,2355,1,2356,19
Uttar Pradesh,Fatehpur Sikri,BRAJENDR SINGH,Independent,2725,0,2725,20
Uttar Pradesh,Fatehpur Sikri,MAHAVIR SINGH SOLANKI,Independent,583,0,583,21
Uttar Pradesh,Fatehpur Sikri,RAKESH SINGH DHANKAR,Independent,650,0,650,22
Uttar Pradesh,Fatehpur Sikri,RAM KUMAR DIXIT,Independent,1657,0,1657,23
Uttar Pradesh,Fatehpur Sikri,RAM BRAJ YADAV,Independent,2057,0,2057,24
Uttar Pradesh,Fatehpur Sikri,SHOBHNA BAUDDHA,Independent,1006,0,1006,25
Uttar Pradesh,Fatehpur Sikri,SATISH KUMAR,Independent,2235,0,2235,26
Uttar Pradesh,Fatehpur Sikri,SANTOSH KUMAR,Independent,3184,0,3184,27
Uttar Pradesh,Fatehpur Sikri,SEEMA DEVI,Independent,1570,1,1571,28
Uttar Pradesh,Fatehpur Sikri,None of the Above,NOTA,2672,5,2677,29
Uttar Pradesh,Firozabad,AKSHAY YADAV,Samajwadi Party,534573,10,534583,1
Uttar Pradesh,Firozabad,ATUL CHATURVEDI,Indian National Congress,7447,0,7447,2
Uttar Pradesh,Firozabad,TH. VISHWADEEP SINGH,Bahujan Samaj Party,118906,3,118909,3
Uttar Pradesh,Firozabad,PROF. S.P. SINGH BAGHEL,Bharatiya Janata Party,420502,22,420524,4
Uttar Pradesh,Firozabad,UPENDRA SINGH,BKPP,3696,0,3696,5
Uttar Pradesh,Firozabad,KHAJAN SINGH,Lok Dal,753,0,753,6
Uttar Pradesh,Firozabad,JAY PRAKASH,Shivsena,1248,0,1248,7
Uttar Pradesh,Firozabad,RAKESH YADAV,Aam Aadmi Party,2805,3,2808,8
Uttar Pradesh,Firozabad,RAJENDRA PRASAD,Bahujan Mukti Party,506,0,506,9
Uttar Pradesh,Firozabad,RAHAT AFROZ,Indian Union Muslim League,498,0,498,10
Uttar Pradesh,Firozabad,LAXMI,Bhartiya Shakti Chetna Party,620,0,620,11
Uttar Pradesh,Firozabad,LAKSHMI  NARAYAN,Rashtriya Janwadi Party (Krantikari),939,0,939,12
Uttar Pradesh,Firozabad,SHAMSHER KHA,Peace Party,3526,0,3526,13
Uttar Pradesh,Firozabad,MIRJA MUKARRAM BAIG,Independent,1470,0,1470,14
Uttar Pradesh,Firozabad,RAJVEER,Independent,2425,0,2425,15
Uttar Pradesh,Firozabad,None of the Above,NOTA,4654,0,4654,16
Uttar Pradesh,Mainpuri,MULAYAM SINGH YADAV,Samajwadi Party,595455,463,595918,1
Uttar Pradesh,Mainpuri,SHATRUGHAN SINGH CHAUHAN,Bharatiya Janata Party,231117,135,231252,2
Uttar Pradesh,Mainpuri,DR. SANGHMITRA MAURYA,Bahujan Samaj Party,142728,105,142833,3
Uttar Pradesh,Mainpuri,ABU NASIM PATHAN,Peace Party,2094,1,2095,4
Uttar Pradesh,Mainpuri,BABA HARDEV SINGH,Aam Aadmi Party,5580,8,5588,5
Uttar Pradesh,Mainpuri,SHISHUPAL SINGH,Bhartiya Shakti Chetna Party,561,0,561,6
Uttar Pradesh,Mainpuri,SATENDRA VEER SINGH CHAUHAN,All India Forward Bloc,872,0,872,7
Uttar Pradesh,Mainpuri,ASHOK KUMAR,Independent,694,1,695,8
Uttar Pradesh,Mainpuri,ALOK NANDAN,Independent,5644,1,5645,9
Uttar Pradesh,Mainpuri,MUKESH KUMAR,Independent,915,1,916,10
Uttar Pradesh,Mainpuri,MUKESH KUMAR SHAKYA,Independent,2542,0,2542,11
Uttar Pradesh,Mainpuri,RAJESHWARI,Independent,1746,0,1746,12
Uttar Pradesh,Mainpuri,HAKIM SINGH,Independent,2278,1,2279,13
Uttar Pradesh,Mainpuri,None of the Above,NOTA,6312,11,6323,14
Uttar Pradesh,Etah,KU. DEVENDRA SINGH YADAV,Samajwadi Party,273921,56,273977,1
Uttar Pradesh,Etah,NOOR MOHAMMAD KHAN,Bahujan Samaj Party,137103,24,137127,2
Uttar Pradesh,Etah,RAJVEER SINGH (RAJU BHAIYA),Bharatiya Janata Party,474810,168,474978,3
Uttar Pradesh,Etah,TH. JOGINDRA SINGH BHADORIYA,MD,12444,1,12445,4
Uttar Pradesh,Etah,RAJENDRA,BRAVP,1021,0,1021,5
Uttar Pradesh,Etah,VINAY,Bhartiya Shakti Chetna Party,2008,0,2008,6
Uttar Pradesh,Etah,THAKUR HEMENDRA VEER SINGH,SSKP,2033,1,2034,7
Uttar Pradesh,Etah,HANS  RAJ SINGH,Aam Aadmi Party,2180,6,2186,8
Uttar Pradesh,Etah,DANVEER,Independent,1333,0,1333,9
Uttar Pradesh,Etah,RAKESH GANDHI,Independent,7119,4,7123,10
Uttar Pradesh,Etah,RAJVEER SINGH,Independent,5847,1,5848,11
Uttar Pradesh,Etah,None of the Above,NOTA,6198,3,6201,12
Uttar Pradesh,Badaun,AKMAL KHAN URF CHAMAN,Bahujan Samaj Party,156866,107,156973,1
Uttar Pradesh,Badaun,DHARMENDRA YADAV,Samajwadi Party,498008,370,498378,2
Uttar Pradesh,Badaun,VAGISH PATHAK,Bharatiya Janata Party,331807,224,332031,3
Uttar Pradesh,Badaun,AJEET PAL SINGH,Peace Party,3421,0,3421,4
Uttar Pradesh,Badaun,ANIL KUMAR SHARMA,Labour Party of India (V.V.Prasad),1992,1,1993,5
Uttar Pradesh,Badaun,PAGLANAND,MD,5748,0,5748,6
Uttar Pradesh,Badaun,MADAN LAL,National Party,791,0,791,7
Uttar Pradesh,Badaun,MAHENDRA PAL,Bhartiya Shakti Chetna Party,860,0,860,8
Uttar Pradesh,Badaun,REENA,Rashtriya Samanta Dal,2065,0,2065,9
Uttar Pradesh,Badaun,VIRENDRA PAL GUPTA,Rashtravadi Janata Party,810,0,810,10
Uttar Pradesh,Badaun,SANTOSH KUMAR GUPTA (SATYMARGI),Republican Party of India (A),1448,0,1448,11
Uttar Pradesh,Badaun,HEMA MEHRA,Aam Aadmi Party,2856,5,2861,12
Uttar Pradesh,Badaun,ATUL KUMAR,Independent,4195,0,4195,13
Uttar Pradesh,Badaun,MUNSHI LAL,Independent,5651,0,5651,14
Uttar Pradesh,Badaun,HAR BHAGWAN,Independent,4083,0,4083,15
Uttar Pradesh,Badaun,None of the Above,NOTA,6283,3,6286,16
Uttar Pradesh,Aonla,DHARMENDRA KUMAR,Bharatiya Janata Party,409533,374,409907,1
Uttar Pradesh,Aonla,SALEEM IQBAL SHERVANI,Indian National Congress,93823,38,93861,2
Uttar Pradesh,Aonla,KUNWAR SARVRAJ SINGH,Samajwadi Party,271207,271,271478,3
Uttar Pradesh,Aonla,SUNITA SHAKYA,Bahujan Samaj Party,189954,246,190200,4
Uttar Pradesh,Aonla,IRSHAD ANSARI ADVOCATE,Peace Party,2697,0,2697,5
Uttar Pradesh,Aonla,OM VEER,Bhartiya Vikas Party,1152,0,1152,6
Uttar Pradesh,Aonla,MOHD. ZARRAR KHAN,BNIP,1440,0,1440,7
Uttar Pradesh,Aonla,JITENDRA SINGH YADAV,NAP,855,0,855,8
Uttar Pradesh,Aonla,NARESH SINGH SOLANKI,Aam Aadmi Party,2299,5,2304,9
Uttar Pradesh,Aonla,PRAMOD KUMAR YADAV,BKrD,1189,0,1189,10
Uttar Pradesh,Aonla,YOGENDRA KUMAR VERMA,Akhil Bharat Hindu Mahasabha,4332,0,4332,11
Uttar Pradesh,Aonla,CAPTAIN P.C. SHARMA,JKM,2711,0,2711,12
Uttar Pradesh,Aonla,ARSHADURRAZA KHAN,Independent,3019,0,3019,13
Uttar Pradesh,Aonla,None of the Above,NOTA,10489,7,10496,14
Uttar Pradesh,Bareilly,AYESHA ISLAM,Samajwadi Party,277473,100,277573,1
Uttar Pradesh,Bareilly,UMESH GAUTAM,Bahujan Samaj Party,105927,122,106049,2
Uttar Pradesh,Bareilly,PRAVEEN SINGH ARON,Indian National Congress,84105,108,84213,3
Uttar Pradesh,Bareilly,MASSARAT WARSI (PAPPU BHAI),Communist Party of India,7639,0,7639,4
Uttar Pradesh,Bareilly,SANTOSH KUMAR GANGWAR,Bharatiya Janata Party,517450,808,518258,5
Uttar Pradesh,Bareilly,ASLAM ADVOCATE,Peace Party,3338,0,3338,6
Uttar Pradesh,Bareilly,LAEEK AHMAD,NAP,719,0,719,7
Uttar Pradesh,Bareilly,SUNIL KUMAR,Aam Aadmi Party,3691,12,3703,8
Uttar Pradesh,Bareilly,KAMAL KISHORE ENGINEER,Independent,1801,5,1806,9
Uttar Pradesh,Bareilly,JAVED KHAN,Independent,963,1,964,10
Uttar Pradesh,Bareilly,NETRAM,Independent,2037,1,2038,11
Uttar Pradesh,Bareilly,MANOJ VIKAT,Independent,1567,0,1567,12
Uttar Pradesh,Bareilly,LOTAN SINGH PATEL,Independent,1402,0,1402,13
Uttar Pradesh,Bareilly,SAYAD RASHID ALI,Independent,1885,0,1885,14
Uttar Pradesh,Bareilly,None of the Above,NOTA,6731,6,6737,15
Uttar Pradesh,Pilibhit,ANIS AHMAD KHAN ALIAS PHOOL BABU,Bahujan Samaj Party,196249,45,196294,1
Uttar Pradesh,Pilibhit,BUDHSEN VERMA,Samajwadi Party,239850,32,239882,2
Uttar Pradesh,Pilibhit,MANEKA SANJAY GANDHI,Bharatiya Janata Party,546815,119,546934,3
Uttar Pradesh,Pilibhit,SANJAY KAPOOR,Indian National Congress,29165,4,29169,4
Uttar Pradesh,Pilibhit,NILIMA SHARMA,Peace Party,2670,0,2670,5
Uttar Pradesh,Pilibhit,RAJEEV AGRAWAL,Aam Aadmi Party,5545,2,5547,6
Uttar Pradesh,Pilibhit,RAM AUTAR,Communist Party of India (Marxist-Lenninist) (Liberation),3187,0,3187,7
Uttar Pradesh,Pilibhit,SANJAY KUMAR,NAP,1259,1,1260,8
Uttar Pradesh,Pilibhit,ARAMAN KHAN,Independent,2170,0,2170,9
Uttar Pradesh,Pilibhit,MOHD NAEEM ANSARI,Independent,2617,0,2617,10
Uttar Pradesh,Pilibhit,MUNESH SINGH,Independent,6151,0,6151,11
Uttar Pradesh,Pilibhit,RAVINDRA KUMAR DEVNATH,Independent,3145,0,3145,12
Uttar Pradesh,Pilibhit,None of the Above,NOTA,11519,2,11521,13
Uttar Pradesh,Shahjahanpur,UMED SINGH KASHYAP,Bahujan Samaj Party,289182,421,289603,1
Uttar Pradesh,Shahjahanpur,KRISHNA RAJ,Bharatiya Janata Party,524025,1107,525132,2
Uttar Pradesh,Shahjahanpur,CHETRAM,Indian National Congress,26974,37,27011,3
Uttar Pradesh,Shahjahanpur,MITHILESH KUMAR,Samajwadi Party,242646,267,242913,4
Uttar Pradesh,Shahjahanpur,KISHAN LAL,Lok Dal,2790,0,2790,5
Uttar Pradesh,Shahjahanpur,PYARE ALIAS RAJKUMAR GAUTAM,Vanchitsamaj Insaaf Party,1378,0,1378,6
Uttar Pradesh,Shahjahanpur,MEVARAM,NAP,1105,0,1105,7
Uttar Pradesh,Shahjahanpur,RAMMURTI,BKrD,1384,0,1384,8
Uttar Pradesh,Shahjahanpur,RAMLAL VERMA,Bahujan Mukti Party,1607,6,1613,9
Uttar Pradesh,Shahjahanpur,SMT REETA SINGH ALIAS REETA BHARTI,Aam Aadmi Party,3584,26,3610,10
Uttar Pradesh,Shahjahanpur,SUNITA SUJATA NAGPAL,Peace Party,12940,5,12945,11
Uttar Pradesh,Shahjahanpur,RAKESH,Independent,2522,0,2522,12
Uttar Pradesh,Shahjahanpur,ROSHAN LAL ALIAS ROSHAN KANAUJIYA,Independent,7871,0,7871,13
Uttar Pradesh,Shahjahanpur,None of the Above,NOTA,9940,24,9964,14
Uttar Pradesh,Kheri,VIPNESH,Communist Party of India,16401,0,16401,1
Uttar Pradesh,Kheri,RAVI PRAKASH VERMA,Samajwadi Party,160110,2,160112,2
Uttar Pradesh,Kheri,RAMGOPAL MISHRA,Independent,2608,0,2608,3
Uttar Pradesh,Kheri,AJAY KUMAR,Bharatiya Janata Party,398563,15,398578,4
Uttar Pradesh,Kheri,ARVIND GIRI,Bahujan Samaj Party,288301,3,288304,5
Uttar Pradesh,Kheri,ZAFAR ALI NAQVI,Indian National Congress,183940,0,183940,6
Uttar Pradesh,Kheri,DINESH KUMAR,Bahujan Mukti Party,2861,0,2861,7
Uttar Pradesh,Kheri,KRISHNA ADHIKARI,Communist Party of India (Marxist-Lenninist) (Liberation),3230,0,3230,8
Uttar Pradesh,Kheri,ASHRAF ALI,Peace Party,3124,0,3124,9
Uttar Pradesh,Kheri,ASHOK,Aam Aadmi Party,3165,0,3165,10
Uttar Pradesh,Kheri,RAMESHWARI,Independent,3514,0,3514,11
Uttar Pradesh,Kheri,None of the Above,NOTA,12031,0,12031,12
Uttar Pradesh,Dhaurahra,REKHA,Bharatiya Janata Party,360223,134,360357,1
Uttar Pradesh,Dhaurahra,ANAND BHADAURIYA,Samajwadi Party,233960,72,234032,2
Uttar Pradesh,Dhaurahra,AJAY VERMA,BJKD,6144,0,6144,3
Uttar Pradesh,Dhaurahra,ANAND KUMAR,Nationalist Congress Party,9963,4,9967,4
Uttar Pradesh,Dhaurahra,KIRTI SINGH,Shivsena,2788,0,2788,5
Uttar Pradesh,Dhaurahra,SWAMI DAYAL,Independent,3491,0,3491,6
Uttar Pradesh,Dhaurahra,DAUD AHMAD,Bahujan Samaj Party,234562,120,234682,7
Uttar Pradesh,Dhaurahra,KUWAR JITIN PRASAD,Indian National Congress,170928,66,170994,8
Uttar Pradesh,Dhaurahra,LEKHRAJ,All India Trinamool Congress,12769,7,12776,9
Uttar Pradesh,Dhaurahra,RAM BALI,Communist Party of India (Marxist),2144,0,2144,10
Uttar Pradesh,Dhaurahra,RAJENDRA KUMAR SINGH,Peace Party,1730,0,1730,11
Uttar Pradesh,Dhaurahra,SUKHVINDRA SINGH,NBDP,4020,1,4021,12
Uttar Pradesh,Dhaurahra,VIVEK MISHRA,NAP,3745,0,3745,13
Uttar Pradesh,Dhaurahra,VIJAY KUMAR TIWARI,Independent,3333,0,3333,14
Uttar Pradesh,Dhaurahra,MALA DEVI,Vanchitsamaj Insaaf Party,1929,0,1929,15
Uttar Pradesh,Dhaurahra,None of the Above,NOTA,8138,0,8138,16
Uttar Pradesh,Sitapur,KAISER JAHAN,Bahujan Samaj Party,366333,186,366519,1
Uttar Pradesh,Sitapur,BHARAT TRIPATHI,Samajwadi Party,156078,92,156170,2
Uttar Pradesh,Sitapur,RAJESH VERMA,Bharatiya Janata Party,417215,331,417546,3
Uttar Pradesh,Sitapur,VAISHALI ALI,Indian National Congress,29092,12,29104,4
Uttar Pradesh,Sitapur,ERAJ BEG,NEP,2195,0,2195,5
Uttar Pradesh,Sitapur,CHAUDHARY LAL BAGHEL,Bahujan Mukti Party,1990,2,1992,6
Uttar Pradesh,Sitapur,JAGDISH NARAYAN SHUKLA,All India Trinamool Congress,8088,1,8089,7
Uttar Pradesh,Sitapur,JAGMOHAN SINGH VERMA,All India Forward Bloc,2549,1,2550,8
Uttar Pradesh,Sitapur,R. K. MISRA,NBDP,2204,1,2205,9
Uttar Pradesh,Sitapur,RAM AVTAR NISHAD,jhspt,2503,1,2504,10
Uttar Pradesh,Sitapur,SHEFALI MISRA,Aam Aadmi Party,2313,6,2319,11
Uttar Pradesh,Sitapur,SANT KUMAR,Communist Party of India (Marxist),1544,0,1544,12
Uttar Pradesh,Sitapur,SANJAY TIWARI,NAP,2372,1,2373,13
Uttar Pradesh,Sitapur,TURAB ALI,Independent,6646,0,6646,14
Uttar Pradesh,Sitapur,PUSHPA DEVI,Independent,3575,0,3575,15
Uttar Pradesh,Sitapur,SUCHITA KUMAR,Independent,8959,0,8959,16
Uttar Pradesh,Sitapur,None of the Above,NOTA,12678,4,12682,17
Uttar Pradesh,Hardoi,ANSHUL VERMA,Bharatiya Janata Party,360473,28,360501,1
Uttar Pradesh,Hardoi,USHA VERMA,Samajwadi Party,276542,1,276543,2
Uttar Pradesh,Hardoi,SHIVE PRASAD VERMA,Bahujan Samaj Party,279158,0,279158,3
Uttar Pradesh,Hardoi,SARVESH KUMAR,Indian National Congress,23298,0,23298,4
Uttar Pradesh,Hardoi,CHANDRAPAL,Bharatiya Republican Paksha,2003,0,2003,5
Uttar Pradesh,Hardoi,RAMDAYAL,Peace Party,1576,0,1576,6
Uttar Pradesh,Hardoi,RAMLAKHAN GAUTAM,ISSP,834,0,834,7
Uttar Pradesh,Hardoi,SANJAY KUMAR,BKrD,830,0,830,8
Uttar Pradesh,Hardoi,SANTRAM,Bahujan Mukti Party,1296,0,1296,9
Uttar Pradesh,Hardoi,HIRA LAL VERMA,Aam Aadmi Party,1667,2,1669,10
Uttar Pradesh,Hardoi,RAMPAL,Independent,1326,0,1326,11
Uttar Pradesh,Hardoi,SHIVEKUMAR,Independent,4740,0,4740,12
Uttar Pradesh,Hardoi,SAROJ KUMAR,Independent,3287,0,3287,13
Uttar Pradesh,Hardoi,SARVESH,Independent,4130,0,4130,14
Uttar Pradesh,Hardoi,SUNIL BHARTI,Independent,4045,0,4045,15
Uttar Pradesh,Hardoi,None of the Above,NOTA,7660,0,7660,16
Uttar Pradesh,Misrikh,ANJU BALA,Bharatiya Janata Party,412468,107,412575,1
Uttar Pradesh,Misrikh,ASHOK KUMAR RAWAT,Bahujan Samaj Party,325139,73,325212,2
Uttar Pradesh,Misrikh,OM PRAKASH,Indian National Congress,33070,5,33075,3
Uttar Pradesh,Misrikh,JAI PRAKASH,Samajwadi Party,194725,34,194759,4
Uttar Pradesh,Misrikh,KANEDI,Bahujan Mukti Party,2772,1,2773,5
Uttar Pradesh,Misrikh,NAGPAL,BKrD,846,1,847,6
Uttar Pradesh,Misrikh,MANSHARAM GAUTAM,Communist Party of India (Marxist),704,0,704,7
Uttar Pradesh,Misrikh,RAJESH KUMAR S/O PARMESHWAR DEEN,Bharatiya Republican Paksha,1158,0,1158,8
Uttar Pradesh,Misrikh,HARINAM,Socialist Party (India),1002,1,1003,9
Uttar Pradesh,Misrikh,RAJESH KUMAR S/O BABOORAM,Independent,951,0,951,10
Uttar Pradesh,Misrikh,RAMPAL,Independent,2234,0,2234,11
Uttar Pradesh,Misrikh,SHABNUM,Independent,1784,1,1785,12
Uttar Pradesh,Misrikh,SWADESH KUMAR,Independent,2970,0,2970,13
Uttar Pradesh,Misrikh,HANS MUKHI KATHERIA,Independent,8635,0,8635,14
Uttar Pradesh,Misrikh,None of the Above,NOTA,9632,1,9633,15
Uttar Pradesh,Unnao,ARUN SHANKAR SHUKLA,Samajwadi Party,208485,176,208661,1
Uttar Pradesh,Unnao,BRAJESH PATHAK,Bahujan Samaj Party,199871,305,200176,2
Uttar Pradesh,Unnao,SUKHDEV,MwSP,4398,3,4401,3
Uttar Pradesh,Unnao,SAKSHI MAHARAJ,Bharatiya Janata Party,518039,795,518834,4
Uttar Pradesh,Unnao,SUMIT TEWARI,NBDP,3397,1,3398,5
Uttar Pradesh,Unnao,ANIL KUMAR MISHRA,Socialist Party (India),1881,0,1881,6
Uttar Pradesh,Unnao,SHALU DHARMENDRA YADAV,SARP,2437,3,2440,7
Uttar Pradesh,Unnao,ANIL KUMAR CHAUDHARY,Independent,9618,0,9618,8
Uttar Pradesh,Unnao,ANNU TANDON,Indian National Congress,196754,344,197098,9
Uttar Pradesh,Unnao,ARVIND KUMAR,Aam Aadmi Party,4191,23,4214,10
Uttar Pradesh,Unnao,ROOP NARAYAN SINGH,Bhartiya Shakti Chetna Party,1816,2,1818,11
Uttar Pradesh,Unnao,GIRJA SHANKAR @ RAJU,Swarajya Party Of India,5871,0,5871,12
Uttar Pradesh,Unnao,SHIVNATH,Independent,3472,0,3472,13
Uttar Pradesh,Unnao,RAKESH KUMAR,Bahujan Mukti Party,2768,3,2771,14
Uttar Pradesh,Unnao,ANIL KUMAR,Independent,3213,1,3214,15
Uttar Pradesh,Unnao,RAMESHWAR,Independent,9277,0,9277,16
Uttar Pradesh,Unnao,MOHAMMAD AMIR KHAN,Independent,4148,0,4148,17
Uttar Pradesh,Unnao,RAJNIKANT,Independent,3987,0,3987,18
Uttar Pradesh,Unnao,SHIVKANT,Independent,3977,1,3978,19
Uttar Pradesh,Unnao,AKHILESH KUMAR,Communist Party of India (Marxist),5127,1,5128,20
Uttar Pradesh,Unnao,CHETRAM PASI,Republican Party of India (A),2591,1,2592,21
Uttar Pradesh,Unnao,None of the Above,NOTA,4618,8,4626,22
Uttar Pradesh,Mohanlalganj,KAUSHAL KISHORE,Bharatiya Janata Party,454392,882,455274,1
Uttar Pradesh,Mohanlalganj,R.K CHAUDHARY,Bahujan Samaj Party,309407,451,309858,2
Uttar Pradesh,Mohanlalganj,NARENDRA GAUTAM,Indian National Congress,52531,67,52598,3
Uttar Pradesh,Mohanlalganj,SUSHILA SAROJ,Samajwadi Party,242091,275,242366,4
Uttar Pradesh,Mohanlalganj,AMIT RAWAT,All India Trinamool Congress,5112,3,5115,5
Uttar Pradesh,Mohanlalganj,OM PRAKASH,Peace Party,1426,1,1427,6
Uttar Pradesh,Mohanlalganj,GOPAL KANAUJIYA,Republican Party of India (A),1826,0,1826,7
Uttar Pradesh,Mohanlalganj,GAUTAM BHARTI,RRP,2225,0,2225,8
Uttar Pradesh,Mohanlalganj,JAGDISH PRASAD GAUTAM,MwSP,1493,1,1494,9
Uttar Pradesh,Mohanlalganj,BRIJLAL,SARP,1631,1,1632,10
Uttar Pradesh,Mohanlalganj,MAHENDRA KUMAR RAWAT,ASaP,1615,2,1617,11
Uttar Pradesh,Mohanlalganj,MEENA RAWAT,NAP,1779,3,1782,12
Uttar Pradesh,Mohanlalganj,MEERA DEVI,MaSPa,2424,1,2425,13
Uttar Pradesh,Mohanlalganj,SANTOSH KUMAR DHARKAR,Indian National League,4280,0,4280,14
Uttar Pradesh,Mohanlalganj,SUNIL GAUTAM,Aam Aadmi Party,9990,41,10031,15
Uttar Pradesh,Mohanlalganj,MAHESH KUMAR,Independent,7411,1,7412,16
Uttar Pradesh,Mohanlalganj,REENA CHAUDHARY,Independent,6303,1,6304,17
Uttar Pradesh,Mohanlalganj,SHATROHANLAL RAWAT,Independent,4214,0,4214,18
Uttar Pradesh,Mohanlalganj,None of the Above,NOTA,4698,10,4708,19
Uttar Pradesh,Lucknow,ABHISHEK MISRA,Samajwadi Party,56597,174,56771,1
Uttar Pradesh,Lucknow,NAKUL DUBEY,Bahujan Samaj Party,64115,334,64449,2
Uttar Pradesh,Lucknow,RAJ NATH SINGH,Bharatiya Janata Party,559033,2073,561106,3
Uttar Pradesh,Lucknow,PROF. RITA BAHUGUNA JOSHI,Indian National Congress,287851,506,288357,4
Uttar Pradesh,Lucknow,SYED JAVED AHMED JAFRI,Aam Aadmi Party,41240,189,41429,5
Uttar Pradesh,Lucknow,TARA PATKAR,Swarajya Party Of India,741,2,743,6
Uttar Pradesh,Lucknow,NAND KUMAR LODHI RAJPOOT,Rashtriya Krantikari Samajwadi Party,442,3,445,7
Uttar Pradesh,Lucknow,RABI DUBEY,NEP,361,0,361,8
Uttar Pradesh,Lucknow,RAJ KUMAR SINGH,Nayee Party,523,0,523,9
Uttar Pradesh,Lucknow,RADHA KRISHNAN,Uttar Pradesh Republican Party,542,0,542,10
Uttar Pradesh,Lucknow,RAMPHAL RAWAT,BHNKP,502,0,502,11
Uttar Pradesh,Lucknow,VIJAY BAHADUR SINGH,MwSP,573,2,575,12
Uttar Pradesh,Lucknow,SHISHU PAL YADAV,Rashtriya Viklang Party,851,0,851,13
Uttar Pradesh,Lucknow,MOHD. SARWAR MALIK,All India Trinamool Congress,1486,0,1486,14
Uttar Pradesh,Lucknow,SUNIL SINGH,Lok Dal,849,0,849,15
Uttar Pradesh,Lucknow,SUMAN VERMA,Bhartiya Shakti Chetna Party,1901,0,1901,16
Uttar Pradesh,Lucknow,SANJEEV MEHROTRA ALIAS PIKKU BHAI,BKP,1174,0,1174,17
Uttar Pradesh,Lucknow,HARI RAM ALIAS HARIBHAI PATEL,SPP,694,0,694,18
Uttar Pradesh,Lucknow,SYED ALI HUSAIN,Independent,1100,0,1100,19
Uttar Pradesh,Lucknow,ASOK PANDE,Independent,930,0,930,20
Uttar Pradesh,Lucknow,ADARSH SHASTRI,Independent,388,1,389,21
Uttar Pradesh,Lucknow,GHANSHYAM SINGH,Independent,281,1,282,22
Uttar Pradesh,Lucknow,PADAM CHANDRA GUPTA,Independent,661,0,661,23
Uttar Pradesh,Lucknow,MANOJ SINGH,Independent,571,1,572,24
Uttar Pradesh,Lucknow,YOGESH CHANDRA BHATT,Independent,337,0,337,25
Uttar Pradesh,Lucknow,RAJEEV RANJAN TIWARI ALIAS RAJ BEHARI,Independent,390,0,390,26
Uttar Pradesh,Lucknow,VINAY PRAKASH MISHRA,Independent,441,0,441,27
Uttar Pradesh,Lucknow,SHAILENDRA SINGH YADAV,Independent,608,0,608,28
Uttar Pradesh,Lucknow,SUBHASH CHANDRA LEHRI,Independent,716,3,719,29
Uttar Pradesh,Lucknow,None of the Above,NOTA,4677,19,4696,30
Uttar Pradesh,Rae Bareli,AJAY AGRAWAL,Bharatiya Janata Party,173716,5,173721,1
Uttar Pradesh,Rae Bareli,PRAVESH SINGH,Bahujan Samaj Party,63633,0,63633,2
Uttar Pradesh,Rae Bareli,SONIA GANDHI,Indian National Congress,526433,1,526434,3
Uttar Pradesh,Rae Bareli,ARCHANA SRIVASTAVA,Aam Aadmi Party,10383,0,10383,4
Uttar Pradesh,Rae Bareli,ANJU SINGH,All India Trinamool Congress,3507,0,3507,5
Uttar Pradesh,Rae Bareli,KIRAN CHAUDHARI,Bahujan Mukti Party,5205,0,5205,6
Uttar Pradesh,Rae Bareli,KAILASH KUMAR,HKRD,2645,0,2645,7
Uttar Pradesh,Rae Bareli,JAWAHAR LAL,NJC,1463,0,1463,8
Uttar Pradesh,Rae Bareli,MOHAMMAD ASHRAF,Vanchitsamaj Insaaf Party,1586,0,1586,9
Uttar Pradesh,Rae Bareli,RATIRAM,SARP,1661,0,1661,10
Uttar Pradesh,Rae Bareli,SHIV SEWAK,RAHM,1493,0,1493,11
Uttar Pradesh,Rae Bareli,SAHAR NAQVI,Lok Dal,2108,0,2108,12
Uttar Pradesh,Rae Bareli,SURESH CHANDRA,MwSP,3330,0,3330,13
Uttar Pradesh,Rae Bareli,PRAMOD KUREEL,Independent,6688,0,6688,14
Uttar Pradesh,Rae Bareli,MANGAL SAIN,Independent,4418,0,4418,15
Uttar Pradesh,Rae Bareli,SHAKIL AHAMAD,Independent,7914,0,7914,16
Uttar Pradesh,Rae Bareli,SAHADAT ALI KHAN,Independent,3538,0,3538,17
Uttar Pradesh,Rae Bareli,None of the Above,NOTA,5409,0,5409,18
Uttar Pradesh,Amethi,DHARMENDRA PRATAP SINGH,Bahujan Samaj Party,57716,0,57716,1
Uttar Pradesh,Amethi,RAHUL GANDHI,Indian National Congress,408650,1,408651,2
Uttar Pradesh,Amethi,SMRITI IRANI,Bharatiya Janata Party,300747,1,300748,3
Uttar Pradesh,Amethi,GOPAL SWAROOP GANDHI,KMBS,5467,0,5467,4
Uttar Pradesh,Amethi,CHHAYA SINGH,All India Trinamool Congress,4109,0,4109,5
Uttar Pradesh,Amethi,ZAHIDA BEGAM,Peace Party,1387,0,1387,6
Uttar Pradesh,Amethi,BABU LAL,Bahujan Mukti Party,1617,0,1617,7
Uttar Pradesh,Amethi,C L MAURYA,PGSP,1871,0,1871,8
Uttar Pradesh,Amethi,RAVI KUMAR,MBCOI,1064,0,1064,9
Uttar Pradesh,Amethi,RADHE MOHAN,ssrd,1753,0,1753,10
Uttar Pradesh,Amethi,RAM ASREY,RaMSP,1572,0,1572,11
Uttar Pradesh,Amethi,RAM NEWAJ,Pragatisheel Manav Samaj Party,1140,0,1140,12
Uttar Pradesh,Amethi,RAMSIDDH YADAV,MwSP,2189,0,2189,13
Uttar Pradesh,Amethi,VASDEO,Communist Party of India (Marxist),2546,0,2546,14
Uttar Pradesh,Amethi,DR. KUMAR VISHVAS,Aam Aadmi Party,25527,0,25527,15
Uttar Pradesh,Amethi,VEDPAL SHASATRI,Vanchitsamaj Insaaf Party,6464,0,6464,16
Uttar Pradesh,Amethi,MOHD HASAN LAHRI,Quami Ekta Dal,4457,0,4457,17
Uttar Pradesh,Amethi,UMAKANT,Independent,3305,0,3305,18
Uttar Pradesh,Amethi,GIRIJA BAKS,Independent,2454,0,2454,19
Uttar Pradesh,Amethi,GANGESH KUMAR GUPTA,Independent,1307,0,1307,20
Uttar Pradesh,Amethi,JAGAT SINGH CHAUDHARY,Independent,1043,0,1043,21
Uttar Pradesh,Amethi,JITENDRA SINGH,Independent,2201,0,2201,22
Uttar Pradesh,Amethi,TULSIRAM,Independent,4884,0,4884,23
Uttar Pradesh,Amethi,DWARIKA PRASAD,Independent,2345,0,2345,24
Uttar Pradesh,Amethi,NARESH SINGH BHADAURIYA,Independent,1255,0,1255,25
Uttar Pradesh,Amethi,BHAGWAN DEEN,Independent,1299,0,1299,26
Uttar Pradesh,Amethi,MITHILESH KUMARI,Independent,2726,0,2726,27
Uttar Pradesh,Amethi,RAMESH CHANDRA,Independent,6422,0,6422,28
Uttar Pradesh,Amethi,RAM SAJIWAN,Independent,2384,0,2384,29
Uttar Pradesh,Amethi,LAL BAHADUR,Independent,2845,0,2845,30
Uttar Pradesh,Amethi,SHIV KUMAR,Independent,2289,0,2289,31
Uttar Pradesh,Amethi,SWAMINATH,Independent,5537,0,5537,32
Uttar Pradesh,Amethi,SONAM KINNAR,Independent,1252,0,1252,33
Uttar Pradesh,Amethi,SANJAY KUMAR,Independent,1015,0,1015,34
Uttar Pradesh,Amethi,None of the Above,NOTA,1784,0,1784,35
Uttar Pradesh,Sultanpur,AMEETA SINGH,Indian National Congress,41983,0,41983,1
Uttar Pradesh,Sultanpur,PAWAN PANDEY,Bahujan Samaj Party,231428,18,231446,2
Uttar Pradesh,Sultanpur,FEROZE VARUN GANDHI,Bharatiya Janata Party,410317,31,410348,3
Uttar Pradesh,Sultanpur,SHAKEEL AHMED,Samajwadi Party,228129,15,228144,4
Uttar Pradesh,Sultanpur,GIRISH LAL,Suheldev Bhartiya Samaj Party,3804,0,3804,5
Uttar Pradesh,Sultanpur,DR. NAFEES AHMAD,RaIP,3381,0,3381,6
Uttar Pradesh,Sultanpur,PITAMBAR NISHAD,Pragatisheel Manav Samaj Party,2737,0,2737,7
Uttar Pradesh,Sultanpur,RAM MILAN,Bahujan Mukti Party,1887,0,1887,8
Uttar Pradesh,Sultanpur,MOHD SHAMIM,Quami Ekta Dal,1637,0,1637,9
Uttar Pradesh,Sultanpur,SHIV SHANKAR,MBCOI,1601,0,1601,10
Uttar Pradesh,Sultanpur,SHAILENDRA PRATAP SINGH,Aam Aadmi Party,5834,1,5835,11
Uttar Pradesh,Sultanpur,SARTAJ KHAN,ADPT,2363,0,2363,12
Uttar Pradesh,Sultanpur,BRIJESH KUMAR,Independent,5751,1,5752,13
Uttar Pradesh,Sultanpur,VARUN GANDHI,Independent,14015,6,14021,14
Uttar Pradesh,Sultanpur,VIJAY,Independent,4630,0,4630,15
Uttar Pradesh,Sultanpur,None of the Above,NOTA,5411,1,5412,16
Uttar Pradesh,Pratapgarh,ASIF NIZAMUDDIN SIDDIQUE,Bahujan Samaj Party,207182,385,207567,1
Uttar Pradesh,Pratapgarh,PRAMOD KUMAR SINGH PATEL,Samajwadi Party,119931,176,120107,2
Uttar Pradesh,Pratapgarh,RAJKUMARI RATNA SINGH,Indian National Congress,138232,388,138620,3
Uttar Pradesh,Pratapgarh,"ASHOK SHUKLA "" SENANI""",Aam Aadmi Party,9972,11,9983,4
Uttar Pradesh,Pratapgarh,NIRMALA DEVI,BaVaP,2764,2,2766,5
Uttar Pradesh,Pratapgarh,FOOLCHANDRA,Shivsena,1859,0,1859,6
Uttar Pradesh,Pratapgarh,BAL KRISHNA,Janata Dal (United),2160,0,2160,7
Uttar Pradesh,Pratapgarh,RAJENDRA SHARMA,RshJP,1570,1,1571,8
Uttar Pradesh,Pratapgarh,RAM SEWAK,Bahujan Mukti Party,4192,15,4207,9
Uttar Pradesh,Pratapgarh,SHESHNATH,SOCIALIST UNITY CENTRE OF INDIA (COMMUNIST),2456,2,2458,10
Uttar Pradesh,Pratapgarh,SANTOSH KUMAR SINGH,All India Trinamool Congress,6306,3,6309,11
Uttar Pradesh,Pratapgarh,KUWAR HARIVANSH SINGH,Apna Dal,375099,690,375789,12
Uttar Pradesh,Pratapgarh,AJMAL KHAN,Independent,3342,0,3342,13
Uttar Pradesh,Pratapgarh,KIRAN MISHRA,Independent,2999,3,3002,14
Uttar Pradesh,Pratapgarh,HARIVANSH,Independent,5575,43,5618,15
Uttar Pradesh,Pratapgarh,None of the Above,NOTA,9093,5,9098,16
Uttar Pradesh,Farrukhabad,JAIVEER SINGH,Bahujan Samaj Party,114509,12,114521,1
Uttar Pradesh,Farrukhabad,MUKESH RAJPUT,Bharatiya Janata Party,406137,58,406195,2
Uttar Pradesh,Farrukhabad,RAMESHWAR SINGH YADAV,Samajwadi Party,255641,52,255693,3
Uttar Pradesh,Farrukhabad,SALMAN KHURSHID,Indian National Congress,95540,3,95543,4
Uttar Pradesh,Farrukhabad,ANJU,Bhartiya Shakti Chetna Party,2254,0,2254,5
Uttar Pradesh,Farrukhabad,KRISHAN KUMAR DIXIT ALIAS K. K. DIXIT,Rashtriya Viklang Party,2107,0,2107,6
Uttar Pradesh,Farrukhabad,MO. TAMAJID,Peace Party,2655,0,2655,7
Uttar Pradesh,Farrukhabad,TARIK PARVEZ,Aam Aadmi Party,1857,0,1857,8
Uttar Pradesh,Farrukhabad,DAYA SHANKAR,ARVP,1864,0,1864,9
Uttar Pradesh,Farrukhabad,RAMNIWAS KATHERIA,Bahujan Mukti Party,941,0,941,10
Uttar Pradesh,Farrukhabad,ANURAG RAJPUT,Independent,1605,0,1605,11
Uttar Pradesh,Farrukhabad,ANOKHEY LAL,Independent,1202,0,1202,12
Uttar Pradesh,Farrukhabad,IMAMUDDIN HUSAIN HUSAIN,Independent,1537,0,1537,13
Uttar Pradesh,Farrukhabad,ANSHU MAHAN,Independent,2066,0,2066,14
Uttar Pradesh,Farrukhabad,KISHAN PAL SINGH,Independent,2933,0,2933,15
Uttar Pradesh,Farrukhabad,MALIKHAN SINGH ADVOCATE,Independent,4659,0,4659,16
Uttar Pradesh,Farrukhabad,MUKESH RAJPUT,Independent,2420,0,2420,17
Uttar Pradesh,Farrukhabad,RAM KISHORE DIWEDI,Independent,4974,0,4974,18
Uttar Pradesh,Farrukhabad,VIMLA DEVI,Independent,2140,0,2140,19
Uttar Pradesh,Farrukhabad,VRAHMA SARAN JATAV,Independent,1809,0,1809,20
Uttar Pradesh,Farrukhabad,SACHIN SINGH YADAV,Independent,58700,3,58703,21
Uttar Pradesh,Farrukhabad,SURESH SARASWAT ALAIS ILLAYCHIWALA,Independent,1013,0,1013,22
Uttar Pradesh,Farrukhabad,None of the Above,NOTA,1986,0,1986,23
Uttar Pradesh,Etawah,AJAY PAL SINGH JATAV,Bahujan Samaj Party,192437,367,192804,1
Uttar Pradesh,Etawah,ASHOK KUMAR DOHAREY,Bharatiya Janata Party,438762,884,439646,2
Uttar Pradesh,Etawah,PREMDAS KATERIYA,Samajwadi Party,266321,379,266700,3
Uttar Pradesh,Etawah,HANS MUKHI KORI,Indian National Congress,13369,28,13397,4
Uttar Pradesh,Etawah,UJIYARE LAL DOHARE,Aam Aadmi Party,5896,27,5923,5
Uttar Pradesh,Etawah,PREM CHANDRA,KMBS,2369,3,2372,6
Uttar Pradesh,Etawah,DR MUKESH SINGH DOHARE,Peace Party,3171,7,3178,7
Uttar Pradesh,Etawah,VINEET KUMAR GAUTAM,Ambedkar Samaj Party,4954,0,4954,8
Uttar Pradesh,Etawah,SIYA RAM PASWAN,ALHP,1788,0,1788,9
Uttar Pradesh,Etawah,HAR BILASH DOHERY,Bahujan Mukti Party,2674,3,2677,10
Uttar Pradesh,Etawah,None of the Above,NOTA,6140,25,6165,11
Uttar Pradesh,Kannauj,DIMPLE YADAV,Samajwadi Party,488946,218,489164,1
Uttar Pradesh,Kannauj,NIRMAL TIWARI,Bahujan Samaj Party,127698,87,127785,2
Uttar Pradesh,Kannauj,SUBRAT PATHAK,Bharatiya Janata Party,468982,275,469257,3
Uttar Pradesh,Kannauj,IMRAN BIN ZAFAR,Aam Aadmi Party,4821,5,4826,4
Uttar Pradesh,Kannauj,GANGA CHARAN,Rashtriya Kranti Party,1282,0,1282,5
Uttar Pradesh,Kannauj,PUSHPA DEVI,Bhartiya Shakti Chetna Party,806,0,806,6
Uttar Pradesh,Kannauj,SUBODH KUMAR,Peace Party,927,0,927,7
Uttar Pradesh,Kannauj,SURENDRA NATH,Bahujan Mukti Party,884,4,888,8
Uttar Pradesh,Kannauj,PRADEEP KUMAR,Independent,963,1,964,9
Uttar Pradesh,Kannauj,MUHAR SINGH AMVADI,Independent,2890,1,2891,10
Uttar Pradesh,Kannauj,RAKESH KUMAR TIWARI ADVOCATE,Independent,5723,0,5723,11
Uttar Pradesh,Kannauj,SANJAY SHAKYA,Independent,2567,0,2567,12
Uttar Pradesh,Kannauj,None of the Above,NOTA,7380,0,7380,13
Uttar Pradesh,Kanpur,DR.MURLI MANOHAR JOSHI,Bharatiya Janata Party,474487,225,474712,1
Uttar Pradesh,Kanpur,SALEEM AHMAD,Bahujan Samaj Party,53193,25,53218,2
Uttar Pradesh,Kanpur,SURENDRA MOHAN AGARWAL,Samajwadi Party,25701,22,25723,3
Uttar Pradesh,Kanpur,SRIPRAKASH JAISWAL,Indian National Congress,251694,72,251766,4
Uttar Pradesh,Kanpur,ANIL AWASTHI,All India Trinamool Congress,1701,0,1701,5
Uttar Pradesh,Kanpur,ANAND MEHROTRA,NEP,361,0,361,6
Uttar Pradesh,Kanpur,DEVENDRA KUMAR SHARMA,Akhil Bharatiya Ashok Sena,296,0,296,7
Uttar Pradesh,Kanpur,MOHD.NASIR KHAN,Peace Party,364,0,364,8
Uttar Pradesh,Kanpur,DR.NIKHIL GUPTA,NBDP,580,0,580,9
Uttar Pradesh,Kanpur,MAHMOOD HUSAIN RAHMANI,Aam Aadmi Party,11910,15,11925,10
Uttar Pradesh,Kanpur,MOHAMMAD.ATEEQ,Rashtrawadi Samaj Party,425,0,425,11
Uttar Pradesh,Kanpur,RAMESH KUMAR GUPTA,Parivartan Samaj Party,433,0,433,12
Uttar Pradesh,Kanpur,VINAYAK RAO TOPE,Swarajya Party Of India,723,0,723,13
Uttar Pradesh,Kanpur,HIMMAT LAL,Akhil Bharatiya Rajarya Sabha,683,0,683,14
Uttar Pradesh,Kanpur,ASHOK PASWAN ADVOCATE,Independent,1398,0,1398,15
Uttar Pradesh,Kanpur,KISHOR BAJPAI,Independent,3005,0,3005,16
Uttar Pradesh,Kanpur,PREM CHANDRA PANDEY,Independent,2350,0,2350,17
Uttar Pradesh,Kanpur,BETALAL DIWAKAR,Independent,665,0,665,18
Uttar Pradesh,Kanpur,MUZAFFAR HUSAIN KHAN,Independent,1069,0,1069,19
Uttar Pradesh,Kanpur,VISHWANATH KATARIA,Independent,929,0,929,20
Uttar Pradesh,Kanpur,KUMARI SARASWATI,Independent,475,0,475,21
Uttar Pradesh,Kanpur,None of the Above,NOTA,2276,2,2278,22
Uttar Pradesh,Akbarpur,ANIL SHUKLA WARSI,Bahujan Samaj Party,202500,87,202587,1
Uttar Pradesh,Akbarpur,DEVENDRA SINGH @ BHOLE SINGH,Bharatiya Janata Party,481379,205,481584,2
Uttar Pradesh,Akbarpur,RAJARAM PAL,Indian National Congress,96800,27,96827,3
Uttar Pradesh,Akbarpur,LAL SINGH TOMAR,Samajwadi Party,146938,64,147002,4
Uttar Pradesh,Akbarpur,AMAR SINGH,Jan Parishad,1890,0,1890,5
Uttar Pradesh,Akbarpur,ARVIND KUMAR,Aam Aadmi Party,7909,5,7914,6
Uttar Pradesh,Akbarpur,DR. OMKAR NATH KATIYAR,ALHP,597,0,597,7
Uttar Pradesh,Akbarpur,GOPI RAMAN,Janata Dal (United),523,0,523,8
Uttar Pradesh,Akbarpur,JASWANT SINGH,Bahujan Mukti Party,1037,0,1037,9
Uttar Pradesh,Akbarpur,DR. BAJARANG PRATAP SONKAR,SARP,799,0,799,10
Uttar Pradesh,Akbarpur,RAMA KANT VERMA,Peace Party,1350,0,1350,11
Uttar Pradesh,Akbarpur,RAMENDRA SINGH TOMAR,Bhartiya Shakti Chetna Party,2754,0,2754,12
Uttar Pradesh,Akbarpur,ASHOK YADAV,Independent,1853,0,1853,13
Uttar Pradesh,Akbarpur,NEERAJ KUMAR ADVOCATE,Independent,2259,0,2259,14
Uttar Pradesh,Akbarpur,BHARTI DEVI PASI ADVOCATE,Independent,5432,0,5432,15
Uttar Pradesh,Akbarpur,MUNNI DEVI,Independent,5331,0,5331,16
Uttar Pradesh,Akbarpur,RAM SEVAK,Independent,3403,0,3403,17
Uttar Pradesh,Akbarpur,VIJAY KUMAR SHARMA,Independent,4285,0,4285,18
Uttar Pradesh,Akbarpur,None of the Above,NOTA,3941,7,3948,19
Uttar Pradesh,Jalaun,GHANSHAYAM ANURAGI,Samajwadi Party,180856,65,180921,1
Uttar Pradesh,Jalaun,BRIJLAL KHABRI,Bahujan Samaj Party,261360,69,261429,2
Uttar Pradesh,Jalaun,BHANU PRATAP SINGH VERMA,Bharatiya Janata Party,548457,174,548631,3
Uttar Pradesh,Jalaun,VIJAY CHAUDHARI,Indian National Congress,82896,7,82903,4
Uttar Pradesh,Jalaun,GANGASINGH,ALHP,2525,0,2525,5
Uttar Pradesh,Jalaun,JAYRAM,Bhartiya Shakti Chetna Party,2047,0,2047,6
Uttar Pradesh,Jalaun,DALCHANDRA ANURAGI,Aam Aadmi Party,3335,2,3337,7
Uttar Pradesh,Jalaun,MANOJ KUMAR,Bharatiya Republican Paksha,4561,0,4561,8
Uttar Pradesh,Jalaun,RAJKUMAR,Peace Party,2816,0,2816,9
Uttar Pradesh,Jalaun,RAMNARAYAN,Bahujan Mukti Party,4942,2,4944,10
Uttar Pradesh,Jalaun,RAM SINGH,Communist Party of India (Marxist-Lenninist) (Liberation),4761,0,4761,11
Uttar Pradesh,Jalaun,None of the Above,NOTA,10290,1,10291,12
Uttar Pradesh,Jhansi,ANURADHA SHARMA,Bahujan Samaj Party,213728,64,213792,1
Uttar Pradesh,Jhansi,UMA BHARATI,Bharatiya Janata Party,575683,206,575889,2
Uttar Pradesh,Jhansi,DR. CHANDRAPAL SINGH YADAV,Samajwadi Party,385360,62,385422,3
Uttar Pradesh,Jhansi,PRADEEP JAIN ''''''''ADITYA'''''''',Indian National Congress,84062,27,84089,4
Uttar Pradesh,Jhansi,ARCHANA,Aam Aadmi Party,5536,0,5536,5
Uttar Pradesh,Jhansi,CHINTAMANI,ARWP,2029,0,2029,6
Uttar Pradesh,Jhansi,NARESH KUMAR,RrSP,4215,0,4215,7
Uttar Pradesh,Jhansi,MAULANA MOHAMMAD,Peace Party,1818,1,1819,8
Uttar Pradesh,Jhansi,SUNIL MASSEY,Shivsena,2121,0,2121,9
Uttar Pradesh,Jhansi,KULDEEP KUMAR,Independent,2036,0,2036,10
Uttar Pradesh,Jhansi,TULA RAM,Independent,2604,1,2605,11
Uttar Pradesh,Jhansi,DILSHAD AHMAD,Independent,2727,0,2727,12
Uttar Pradesh,Jhansi,RACHNA SHARMA,Independent,4522,0,4522,13
Uttar Pradesh,Jhansi,RAJENDRA KUMAR,Independent,8600,0,8600,14
Uttar Pradesh,Jhansi,RAM KUMAR ''''''''ANK SHASTRI'''''''',Independent,11442,1,11443,15
Uttar Pradesh,Jhansi,None of the Above,NOTA,13958,1,13959,16
Uttar Pradesh,Hamirpur,KUNWAR PUSHPENDRA SINGH CHANDEL,Bharatiya Janata Party,453866,18,453884,1
Uttar Pradesh,Hamirpur,"PRITAM SINGH LODHI ""KISAAN""",Indian National Congress,78229,0,78229,2
Uttar Pradesh,Hamirpur,BISHAMBHAR PRASAD NISHAD,Samajwadi Party,187095,1,187096,3
Uttar Pradesh,Hamirpur,RAKESH KUMAR GOSWAMI,Bahujan Samaj Party,176355,1,176356,4
Uttar Pradesh,Hamirpur,ATUL KUMAR PRAJAPATI,Aam Aadmi Party,9662,1,9663,5
Uttar Pradesh,Hamirpur,ANIL KUMAR,Ambedkar Samaj Party,4860,0,4860,6
Uttar Pradesh,Hamirpur,AVINASH KUMAR MISHRA,All India Trinamool Congress,6297,0,6297,7
Uttar Pradesh,Hamirpur,KAILASH PRASAD NISHAD,EKSP,1756,0,1756,8
Uttar Pradesh,Hamirpur,RAMESH PRAJAPATI,MBCOI,2981,0,2981,9
Uttar Pradesh,Hamirpur,RAMSAJIVAN,Bhartiya Shakti Chetna Party,2955,0,2955,10
Uttar Pradesh,Hamirpur,VIVEK KUMAR,Rashtriya Krantikari Samajwadi Party,5749,0,5749,11
Uttar Pradesh,Hamirpur,SHRIPAL,BC,3435,0,3435,12
Uttar Pradesh,Hamirpur,KIRAN,Independent,4079,0,4079,13
Uttar Pradesh,Hamirpur,PRAVESH KUMAR VYAS,Independent,4314,0,4314,14
Uttar Pradesh,Hamirpur,VIMLESH,Independent,23137,0,23137,15
Uttar Pradesh,Hamirpur,None of the Above,NOTA,10449,0,10449,16
Uttar Pradesh,Banda,BAL KUMAR PATEL ALIAS RAJKUMAR,Samajwadi Party,189714,16,189730,1
Uttar Pradesh,Banda,BHAIRON PRASAD MISHRA,Bharatiya Janata Party,342008,58,342066,2
Uttar Pradesh,Banda,RAMCHANDRA SARAS,Communist Party of India,15156,0,15156,3
Uttar Pradesh,Banda,VIVEK KUMAR SINGH,Indian National Congress,36647,3,36650,4
Uttar Pradesh,Banda,R. K. SINGH PATEL,Bahujan Samaj Party,226264,14,226278,5
Uttar Pradesh,Banda,AMAR SINGH RATHAUR,Aam Aadmi Party,6438,1,6439,6
Uttar Pradesh,Banda,PAPPU YADAV,Janata Dal (United),2436,0,2436,7
Uttar Pradesh,Banda,PRABHAKAR PRASAD,BKSL,2605,0,2605,8
Uttar Pradesh,Banda,VISHVAMBHAR NATH,Bahujan Mukti Party,4755,0,4755,9
Uttar Pradesh,Banda,MO. SAGEER,Peace Party,3201,0,3201,10
Uttar Pradesh,Banda,SUSHEELA SINGH,Bhartiya Shakti Chetna Party,2931,0,2931,11
Uttar Pradesh,Banda,NARENDRA KUMAR SHRIVASTAVA,Independent,5115,0,5115,12
Uttar Pradesh,Banda,VIJAY PRAKASH,Independent,7140,0,7140,13
Uttar Pradesh,Banda,None of the Above,NOTA,13823,1,13824,14
Uttar Pradesh,Fatehpur,AFZAL SIDDIQUI,Bahujan Samaj Party,298524,264,298788,1
Uttar Pradesh,Fatehpur,USHA MAURYA,Indian National Congress,46550,38,46588,2
Uttar Pradesh,Fatehpur,NIRANJAN JYOTI,Bharatiya Janata Party,485360,634,485994,3
Uttar Pradesh,Fatehpur,RAKESH SACHAN,Samajwadi Party,179590,134,179724,4
Uttar Pradesh,Fatehpur,ASHOK MISHRA,SARP,3027,2,3029,5
Uttar Pradesh,Fatehpur,ZAINUL ABDIN,Aam Aadmi Party,2443,11,2454,6
Uttar Pradesh,Fatehpur,MOHAMMAD JAVED,NBDP,1656,1,1657,7
Uttar Pradesh,Fatehpur,RAMKRISHNA TRIPATHI,All India Trinamool Congress,7576,2,7578,8
Uttar Pradesh,Fatehpur,RAMLOCHAN SEN,Bahujan Mukti Party,2171,2,2173,9
Uttar Pradesh,Fatehpur,RUKMINI DEVI NISHAD,Pragatisheel Manav Samaj Party,1345,0,1345,10
Uttar Pradesh,Fatehpur,ARVIND KUMAR,Independent,1966,1,1967,11
Uttar Pradesh,Fatehpur,CHANDRABHAN SINGH,Independent,2498,0,2498,12
Uttar Pradesh,Fatehpur,RANJANA KAKKAR,Independent,5448,0,5448,13
Uttar Pradesh,Fatehpur,SRIDEVI,Independent,5838,0,5838,14
Uttar Pradesh,Fatehpur,None of the Above,NOTA,11603,4,11607,15
Uttar Pradesh,Kaushambi,MAHENDRA KUMAR,Indian National Congress,31881,24,31905,1
Uttar Pradesh,Kaushambi,VINOD KUMAR SONKAR,Bharatiya Janata Party,331480,244,331724,2
Uttar Pradesh,Kaushambi,SHAILENDRA KUMAR,Samajwadi Party,288643,181,288824,3
Uttar Pradesh,Kaushambi,SURESH PASI,Bahujan Samaj Party,201191,131,201322,4
Uttar Pradesh,Kaushambi,MALTI DEVI,Rashtriya Samanta Dal,6555,1,6556,5
Uttar Pradesh,Kaushambi,RAJENDRA SONKAR,Lok Dal,6389,0,6389,6
Uttar Pradesh,Kaushambi,SHRIPAL,Bahujan Mukti Party,7347,3,7350,7
Uttar Pradesh,Kaushambi,SWARNALATA SUMAN,Aam Aadmi Party,3691,2,3693,8
Uttar Pradesh,Kaushambi,CHHEDDOO,Independent,3342,0,3342,9
Uttar Pradesh,Kaushambi,BEENA RANI,Independent,4958,0,4958,10
Uttar Pradesh,Kaushambi,MOHAN LAL,Independent,9182,0,9182,11
Uttar Pradesh,Kaushambi,None of the Above,NOTA,15169,0,15169,12
Uttar Pradesh,Phulpur,KAPIL MUNI KARWARIYA,Bahujan Samaj Party,163578,132,163710,1
Uttar Pradesh,Phulpur,KESHAV PRASAD MAURYA,Bharatiya Janata Party,503011,553,503564,2
Uttar Pradesh,Phulpur,MOHD. KAIF,Indian National Congress,58090,37,58127,3
Uttar Pradesh,Phulpur,DHARAM RAJ SINGH PATEL,Samajwadi Party,195082,174,195256,4
Uttar Pradesh,Phulpur,GYANENDRA KUMAR SRIVASTAVA (GYANI BHAI),Nationalist Congress Party,2704,2,2706,5
Uttar Pradesh,Phulpur,GANESHJI TRIPATHI,RaBaP,1521,0,1521,6
Uttar Pradesh,Phulpur,DAKKHINI PRASAD KUSHWAHA,RGD,1111,0,1111,7
Uttar Pradesh,Phulpur,NATHU RAM BOUDHA,Bahujan Mukti Party,1304,2,1306,8
Uttar Pradesh,Phulpur,PARVEZ ASHFAQUE SIDDIQUI,Quami Ekta Dal,1301,1,1302,9
Uttar Pradesh,Phulpur,SHIMALA SHRI,Aam Aadmi Party,7369,15,7384,10
Uttar Pradesh,Phulpur,SURENDRA KUMAR MISHRA,Lok Dal,1585,0,1585,11
Uttar Pradesh,Phulpur,ZIAOUL HAQUE,Independent,3392,0,3392,12
Uttar Pradesh,Phulpur,DR. NEERAJ,Independent,2185,2,2187,13
Uttar Pradesh,Phulpur,MITHILESH KUMAR,Independent,3114,0,3114,14
Uttar Pradesh,Phulpur,MILAN MUKERJEE,Independent,5651,1,5652,15
Uttar Pradesh,Phulpur,None of the Above,NOTA,8422,2,8424,16
Uttar Pradesh,Allahabad,KESHRI DEVI,Bahujan Samaj Party,161891,182,162073,1
Uttar Pradesh,Allahabad,NAND GOPAL GUPTA NANDI,Indian National Congress,102414,39,102453,2
Uttar Pradesh,Allahabad,SHYAMA CHARAN GUPTA,Bharatiya Janata Party,313465,307,313772,3
Uttar Pradesh,Allahabad,KUNWAR REWATI RAMAN SINGH ALIAS MANI,Samajwadi Party,251569,194,251763,4
Uttar Pradesh,Allahabad,MOHD. AMEEN AZHAR ANSARI,Quami Ekta Dal,4424,2,4426,5
Uttar Pradesh,Allahabad,ADARSH SHASTRI,Aam Aadmi Party,6420,19,6439,6
Uttar Pradesh,Allahabad,GAYTRI PRASAD,Bhartiya Shakti Chetna Party,1292,1,1293,7
Uttar Pradesh,Allahabad,CHANDRA PRAKASH TIWARI ALIAS C. P. TIWARI (ADVOCATE),BKSL,1221,0,1221,8
Uttar Pradesh,Allahabad,NISTHA DEV MAURYA,PGSP,2181,0,2181,9
Uttar Pradesh,Allahabad,MAHENDRA KUMAR,Bahujan Mukti Party,4188,2,4190,10
Uttar Pradesh,Allahabad,SHYAM SUNDAR DAS,ssrd,2115,0,2115,11
Uttar Pradesh,Allahabad,RAJENDRA PRASAD,kajp,1730,0,1730,12
Uttar Pradesh,Allahabad,WAHID ALI ALIAS WAJID ALI,Rashtriya Ulama Council,2332,0,2332,13
Uttar Pradesh,Allahabad,SANJAY ROBINSON,NAP,3315,0,3315,14
Uttar Pradesh,Allahabad,AJEET KUMAR,Independent,3387,1,3388,15
Uttar Pradesh,Allahabad,DRAUPADI DEVI,Independent,8320,1,8321,16
Uttar Pradesh,Allahabad,PARMANAND,Independent,3744,0,3744,17
Uttar Pradesh,Allahabad,BRIJESH KUMAR,Independent,1438,0,1438,18
Uttar Pradesh,Allahabad,SHYAM CHARAN,Independent,2592,1,2593,19
Uttar Pradesh,Allahabad,SHIV PRASAD AGRAHARI,Independent,4324,0,4324,20
Uttar Pradesh,Allahabad,SHAILENDRA KUMAR PRAJAPATI,Independent,1209,3,1212,21
Uttar Pradesh,Allahabad,HIRA LAL,Independent,1711,0,1711,22
Uttar Pradesh,Allahabad,HANSRAJ,Independent,1928,0,1928,23
Uttar Pradesh,Allahabad,None of the Above,NOTA,3623,1,3624,24
Uttar Pradesh,Barabanki,KAMLA PRASAD RAWAT,Bahujan Samaj Party,167150,0,167150,1
Uttar Pradesh,Barabanki,P. L. PUNIA,Indian National Congress,242332,4,242336,2
Uttar Pradesh,Barabanki,PRIYANKA SINGH RAWAT,Bharatiya Janata Party,454211,3,454214,3
Uttar Pradesh,Barabanki,RAJRANI RAWAT,Samajwadi Party,159284,0,159284,4
Uttar Pradesh,Barabanki,KISHAN LAL,Shivsena,3261,0,3261,5
Uttar Pradesh,Barabanki,P. C. KUREEL,Indian National League,2560,0,2560,6
Uttar Pradesh,Barabanki,DINESH CHANDRA GAUTAM,Aam Aadmi Party,3126,0,3126,7
Uttar Pradesh,Barabanki,NITIN SINGH,NAP,1315,0,1315,8
Uttar Pradesh,Barabanki,BABU LAL,MwSP,2035,0,2035,9
Uttar Pradesh,Barabanki,MEDI LAL,Bahujan Mukti Party,2171,0,2171,10
Uttar Pradesh,Barabanki,RAJESH KUMAR VIDYARTHI,Peace Party,7980,0,7980,11
Uttar Pradesh,Barabanki,ABHILAKH RAWAT,Independent,3038,0,3038,12
Uttar Pradesh,Barabanki,KHANJAN LAL,Independent,7136,0,7136,13
Uttar Pradesh,Barabanki,MAHESH,Independent,3836,0,3836,14
Uttar Pradesh,Barabanki,None of the Above,NOTA,8726,0,8726,15
Uttar Pradesh,Faizabad,JITENDRA KUMAR SINGH (BABLU BHAIYA),Bahujan Samaj Party,141814,13,141827,1
Uttar Pradesh,Faizabad,NIRMAL KHATRI,Indian National Congress,129896,21,129917,2
Uttar Pradesh,Faizabad,MITRASEN YADAV,Samajwadi Party,208965,21,208986,3
Uttar Pradesh,Faizabad,LALLU SINGH,Bharatiya Janata Party,491663,98,491761,4
Uttar Pradesh,Faizabad,JAI RAM SINGH JAI,LPSP,5702,0,5702,5
Uttar Pradesh,Faizabad,NASREEN BANO,Rashtriya Ulama Council,2678,0,2678,6
Uttar Pradesh,Faizabad,MAKASUD ALI,Peace Party,5960,3,5963,7
Uttar Pradesh,Faizabad,MAYURI TIWARI,Aam Aadmi Party,4793,2,4795,8
Uttar Pradesh,Faizabad,RADHIKA PRASAD,ISSP,9055,0,9055,9
Uttar Pradesh,Faizabad,RAM JANAM,MADP,6308,0,6308,10
Uttar Pradesh,Faizabad,SHAILENDRA KUMAR SHUKLA,NAP,4187,0,4187,11
Uttar Pradesh,Faizabad,None of the Above,NOTA,11537,0,11537,12
Uttar Pradesh,Ambedkar Nagar,ASHOK SINGH,Indian National Congress,22774,1,22775,1
Uttar Pradesh,Ambedkar Nagar,RAKESH PANDEY,Bahujan Samaj Party,292669,6,292675,2
Uttar Pradesh,Ambedkar Nagar,RAM MURTI VERMA,Samajwadi Party,234455,12,234467,3
Uttar Pradesh,Ambedkar Nagar,HARI OM PANDEY,Bharatiya Janata Party,432074,30,432104,4
Uttar Pradesh,Ambedkar Nagar,GOPAL NISHAD,Suheldev Bhartiya Samaj Party,5792,0,5792,5
Uttar Pradesh,Ambedkar Nagar,J.S. KASHYAP(JAHAR SINGH KASHYAP),Bahujan Mukti Party,6896,0,6896,6
Uttar Pradesh,Ambedkar Nagar,BALMUKUND DHURIYA,Communist Party of India (Marxist-Lenninist) (Liberation),1942,0,1942,7
Uttar Pradesh,Ambedkar Nagar,BRIJESH KUMAR,Aam Aadmi Party,3025,0,3025,8
Uttar Pradesh,Ambedkar Nagar,RAM BAHAL VERMA,SPP,1137,0,1137,9
Uttar Pradesh,Ambedkar Nagar,SREERAM,MBCOI,4138,0,4138,10
Uttar Pradesh,Ambedkar Nagar,SURENDRA KUMAR,ARVP,2590,0,2590,11
Uttar Pradesh,Ambedkar Nagar,SURESH KUMAR BAUDDH,MADP,7694,0,7694,12
Uttar Pradesh,Ambedkar Nagar,TIGER RAMNIHOR PATEL,Independent,7040,0,7040,13
Uttar Pradesh,Ambedkar Nagar,VINOD KUMAR TIWARI,Independent,4707,0,4707,14
Uttar Pradesh,Ambedkar Nagar,None of the Above,NOTA,7422,0,7422,15
Uttar Pradesh,Bahraich,"""COMANDO"" KAMAL KISHOR",Indian National Congress,24418,3,24421,1
Uttar Pradesh,Bahraich,DR.VIJAY KUMAR,Bahujan Samaj Party,96883,21,96904,2
Uttar Pradesh,Bahraich,SHABBIR AHMAD,Samajwadi Party,336696,51,336747,3
Uttar Pradesh,Bahraich,SADHVI SAVITRI BAI FOOLE,Bharatiya Janata Party,432286,106,432392,4
Uttar Pradesh,Bahraich,JAGAT RAM,Aam Aadmi Party,8318,1,8319,5
Uttar Pradesh,Bahraich,MADHAV,Lok Dal,2676,0,2676,6
Uttar Pradesh,Bahraich,RAMASHANKER GOND,jhspt,5735,0,5735,7
Uttar Pradesh,Bahraich,VINOD KUMAR,Bahujan Mukti Party,3719,0,3719,8
Uttar Pradesh,Bahraich,HIRA LAL RAO,ANC,4026,0,4026,9
Uttar Pradesh,Bahraich,RAM NARESH,Independent,5826,0,5826,10
Uttar Pradesh,Bahraich,None of the Above,NOTA,13498,0,13498,11
Uttar Pradesh,Kaiserganj,KRISHNA KUMAR OJHA,Bahujan Samaj Party,146542,184,146726,1
Uttar Pradesh,Kaiserganj,BRIJ BHUSAN SHARAN SINGH,Bharatiya Janata Party,380984,516,381500,2
Uttar Pradesh,Kaiserganj,MUKESH SRIVASTAV ALIAS GYANENDRA PRATAP,Indian National Congress,57383,18,57401,3
Uttar Pradesh,Kaiserganj,VINOD KUMAR ALIAS  PANDIT SINGH,Samajwadi Party,303091,191,303282,4
Uttar Pradesh,Kaiserganj,GOVIND PRASAD,SPP,5849,0,5849,5
Uttar Pradesh,Kaiserganj,CHAMAN LAL KASAUNDHAN,Lok Dal,1821,1,1822,6
Uttar Pradesh,Kaiserganj,NIRHU,Communist Party of India (Marxist),1466,0,1466,7
Uttar Pradesh,Kaiserganj,NIHALUDDIN AHAMAD,AIPF,2119,0,2119,8
Uttar Pradesh,Kaiserganj,RIZWAN AHMAD,Aam Aadmi Party,3706,4,3710,9
Uttar Pradesh,Kaiserganj,JAMEER AHMAD,Independent,3901,4,3905,10
Uttar Pradesh,Kaiserganj,NISHANT KANCHAN,Independent,3238,8,3246,11
Uttar Pradesh,Kaiserganj,PRAHLAD  NATH MISHRA,Independent,3862,5,3867,12
Uttar Pradesh,Kaiserganj,MUNNI,Independent,5240,5,5245,13
Uttar Pradesh,Kaiserganj,RAMPHER  ALIAS  CHUNTI,Independent,11364,2,11366,14
Uttar Pradesh,Kaiserganj,None of the Above,NOTA,11847,6,11853,15
Uttar Pradesh,Shrawasti,ATIQ AHMAD,Samajwadi Party,259986,65,260051,1
Uttar Pradesh,Shrawasti,DADDAN MISHRA,Bharatiya Janata Party,345872,92,345964,2
Uttar Pradesh,Shrawasti,LAL JI VERMA,Bahujan Samaj Party,194827,63,194890,3
Uttar Pradesh,Shrawasti,VINAY KUMAR PANDEY ''''''''VINNU'''''''',Indian National Congress,20000,6,20006,4
Uttar Pradesh,Shrawasti,PRAKSH CHANDRA MISHRA,JSK,4489,0,4489,5
Uttar Pradesh,Shrawasti,RATNESH,Aam Aadmi Party,2577,1,2578,6
Uttar Pradesh,Shrawasti,RAM SUDHI,JSEP,2961,0,2961,7
Uttar Pradesh,Shrawasti,RIZWAN ZAHEER,Peace Party,101807,10,101817,8
Uttar Pradesh,Shrawasti,SAXSEN,SPP,3188,0,3188,9
Uttar Pradesh,Shrawasti,ARJUN YADAV,Independent,3730,0,3730,10
Uttar Pradesh,Shrawasti,ARUN KUMAR,Independent,10083,0,10083,11
Uttar Pradesh,Shrawasti,TEJ BAHADUR,Independent,3474,0,3474,12
Uttar Pradesh,Shrawasti,RAM ADHAR,Independent,6278,0,6278,13
Uttar Pradesh,Shrawasti,VIJAY KUMAR,Independent,5542,0,5542,14
Uttar Pradesh,Shrawasti,None of the Above,NOTA,14587,0,14587,15
Uttar Pradesh,Gonda,AKBAR AHMAD DUMPY,Bahujan Samaj Party,116051,127,116178,1
Uttar Pradesh,Gonda,OM PRAKASH,Communist Party of India,18445,5,18450,2
Uttar Pradesh,Gonda,KIRTI VARDHAN SINGH,Bharatiya Janata Party,358978,661,359639,3
Uttar Pradesh,Gonda,NANDITA SHUKLA,Samajwadi Party,198903,324,199227,4
Uttar Pradesh,Gonda,BENI PRASAD VERMA,Indian National Congress,102120,134,102254,5
Uttar Pradesh,Gonda,AJAY  KUMAR  PRABHAKAR,Bahujan Mukti Party,3193,7,3200,6
Uttar Pradesh,Gonda,PREM KUMAR,MBCOI,1900,0,1900,7
Uttar Pradesh,Gonda,MASOOD ALAM KHAN,Peace Party,42730,14,42744,8
Uttar Pradesh,Gonda,MAHESH KUMAR,Jan Parishad,2550,5,2555,9
Uttar Pradesh,Gonda,MASHOOQ AHMAD,Aam Aadmi Party,3346,12,3358,10
Uttar Pradesh,Gonda,RAJENDRA PRASAD,SPP,1517,2,1519,11
Uttar Pradesh,Gonda,RAJESH  KUMAR  MAURYA,Socialist Party (India),2196,3,2199,12
Uttar Pradesh,Gonda,SATYA PRAKASH,Shivsena,4743,5,4748,13
Uttar Pradesh,Gonda,TILAK RAM,Independent,5374,0,5374,14
Uttar Pradesh,Gonda,BRIJNANDAN TIWARI,Independent,2393,2,2395,15
Uttar Pradesh,Gonda,None of the Above,NOTA,7983,5,7988,16
Uttar Pradesh,Domariyaganj,JAGDAMBIKA PAL,Bharatiya Janata Party,298845,0,298845,1
Uttar Pradesh,Domariyaganj,MATA PRASAD PANDEY,Samajwadi Party,174778,0,174778,2
Uttar Pradesh,Domariyaganj,MUHAMMAD MUQEEM,Bahujan Samaj Party,195257,0,195257,3
Uttar Pradesh,Domariyaganj,VASUNDHARA,Indian National Congress,88117,0,88117,4
Uttar Pradesh,Domariyaganj,HAMIDULLAH CHAUDHARY,Nationalist Congress Party,7159,0,7159,5
Uttar Pradesh,Domariyaganj,DR. MOHD. AYUB,Peace Party,99242,0,99242,6
Uttar Pradesh,Domariyaganj,ARJUN SINGH,Bahujan Mukti Party,9529,0,9529,7
Uttar Pradesh,Domariyaganj,PINGLE PRASAD,S(J),5521,0,5521,8
Uttar Pradesh,Domariyaganj,BADRE ALAM,Aam Aadmi Party,3174,0,3174,9
Uttar Pradesh,Domariyaganj,MANOJ KUMAR,Suheldev Bhartiya Samaj Party,2709,0,2709,10
Uttar Pradesh,Domariyaganj,RAVI KUMAR,SPP,2535,0,2535,11
Uttar Pradesh,Domariyaganj,DR. SATYENDRA  NATH PANDEY,AAMJP,9371,0,9371,12
Uttar Pradesh,Domariyaganj,SANTRAM,BRABSVP,3238,0,3238,13
Uttar Pradesh,Domariyaganj,KALI RAM,Independent,4939,0,4939,14
Uttar Pradesh,Domariyaganj,DIWAKAR PRASAD,Independent,5123,0,5123,15
Uttar Pradesh,Domariyaganj,MUKESH NARAYAN SHUKLA URF GYANESH NARAYAN SHUKLA,Independent,10952,0,10952,16
Uttar Pradesh,Domariyaganj,RAM UGRAH,Independent,7762,0,7762,17
Uttar Pradesh,Domariyaganj,None of the Above,NOTA,6776,0,6776,18
Uttar Pradesh,Basti,AMBIKA SINGH,Indian National Congress,27673,0,27673,1
Uttar Pradesh,Basti,"BRIJ KISHOR SINGH ""DIMPAL""",Samajwadi Party,324114,4,324118,2
Uttar Pradesh,Basti,RAM PRASAD CHAUDHARY,Bahujan Samaj Party,283745,2,283747,3
Uttar Pradesh,Basti,HARISH CHANDRA  ALIAS  HARISH DWIVEDI,Bharatiya Janata Party,357673,7,357680,4
Uttar Pradesh,Basti,ANAND RAJPAL,Aam Aadmi Party,8407,0,8407,5
Uttar Pradesh,Basti,PURUSHOTTAM PANDEY,Peace Party,8172,0,8172,6
Uttar Pradesh,Basti,BHAGWANDAS,BSP(K),3532,0,3532,7
Uttar Pradesh,Basti,RAM KARAN ALIAS R.K. GAUTAM,Bahujan Mukti Party,2803,0,2803,8
Uttar Pradesh,Basti,SHIVPOOJAN RAJBHAR,Suheldev Bhartiya Samaj Party,7063,0,7063,9
Uttar Pradesh,Basti,SITA RAM,Jan Parishad,2240,0,2240,10
Uttar Pradesh,Basti,ARUN KUMAR,Independent,3587,0,3587,11
Uttar Pradesh,Basti,KRISHNA  KUMAR UPADHYAY ADVOCATE,Independent,4823,0,4823,12
Uttar Pradesh,Basti,RAM SHANKAR GUPTA,Independent,4521,0,4521,13
Uttar Pradesh,Basti,None of the Above,NOTA,10168,0,10168,14
Uttar Pradesh,Sant Kabir Nagar,BHAL CHANDRA YADAV,Samajwadi Party,240167,2,240169,1
Uttar Pradesh,Sant Kabir Nagar,BHISM SHANKAR ALIAS KUSHAL TIWARI,Bahujan Samaj Party,250910,4,250914,2
Uttar Pradesh,Sant Kabir Nagar,ROHIT KUMAR PANDEY,Indian National Congress,22029,0,22029,3
Uttar Pradesh,Sant Kabir Nagar,SHARAD TRIPATHI,Bharatiya Janata Party,348884,8,348892,4
Uttar Pradesh,Sant Kabir Nagar,AFTAB ALAM KHAN,Aam Aadmi Party,7457,1,7458,5
Uttar Pradesh,Sant Kabir Nagar,JANTRI LAL CHAUHAN,Jan Parishad,2439,0,2439,6
Uttar Pradesh,Sant Kabir Nagar,JYOTI SINGH,BSP(K),1884,0,1884,7
Uttar Pradesh,Sant Kabir Nagar,PREM PRAKASH,IPP,2155,0,2155,8
Uttar Pradesh,Sant Kabir Nagar,SANT SIROMANI BABOOLAL YADAV MAHARAJ JI,Suheldev Bhartiya Samaj Party,3900,0,3900,9
Uttar Pradesh,Sant Kabir Nagar,MOHAMMAD ALI,People's Party of India,4082,0,4082,10
Uttar Pradesh,Sant Kabir Nagar,RAVIKANT,MBCOI,1721,0,1721,11
Uttar Pradesh,Sant Kabir Nagar,RAJMANI,Bahujan Mukti Party,5036,0,5036,12
Uttar Pradesh,Sant Kabir Nagar,RAJARAM,Peace Party,69193,0,69193,13
Uttar Pradesh,Sant Kabir Nagar,RAJENDRA KUMAR,Rashtriya Janwadi Party (Krantikari),2278,0,2278,14
Uttar Pradesh,Sant Kabir Nagar,LOTAN URF LAUTAN PRASAD,Sanyukt Samajwadi Dal,3618,0,3618,15
Uttar Pradesh,Sant Kabir Nagar,SHABBEER HUSEN,jhspt,8993,0,8993,16
Uttar Pradesh,Sant Kabir Nagar,APARNA,Independent,11046,0,11046,17
Uttar Pradesh,Sant Kabir Nagar,AMIT,Independent,2796,0,2796,18
Uttar Pradesh,Sant Kabir Nagar,KRIPANARAYAN RAI,Independent,1215,0,1215,19
Uttar Pradesh,Sant Kabir Nagar,KAILASH NATH BELDAR,Independent,3181,0,3181,20
Uttar Pradesh,Sant Kabir Nagar,JAIYANTRI PRASAD,Independent,1335,0,1335,21
Uttar Pradesh,Sant Kabir Nagar,MOHAMMAD IRFAN,Independent,2164,0,2164,22
Uttar Pradesh,Sant Kabir Nagar,SHAYAM LAL,Independent,1477,0,1477,23
Uttar Pradesh,Sant Kabir Nagar,SUBODH CHANDRA,Independent,3061,0,3061,24
Uttar Pradesh,Sant Kabir Nagar,SURENDRA KUMAR CHAUDHARY,Independent,5866,0,5866,25
Uttar Pradesh,Sant Kabir Nagar,None of the Above,NOTA,4747,0,4747,26
Uttar Pradesh,Maharajganj,AKHILESH,Samajwadi Party,213973,1,213974,1
Uttar Pradesh,Maharajganj,KASHI NATH SHUKLA,Bahujan Samaj Party,231084,0,231084,2
Uttar Pradesh,Maharajganj,PANKAJ,Bharatiya Janata Party,471541,1,471542,3
Uttar Pradesh,Maharajganj,HARSH VARDHAN,Indian National Congress,57193,0,57193,4
Uttar Pradesh,Maharajganj,ARAT KHARVAR,Bahujan Mukti Party,3752,0,3752,5
Uttar Pradesh,Maharajganj,KAVILAS,Suheldev Bhartiya Samaj Party,5195,0,5195,6
Uttar Pradesh,Maharajganj,MUMMATAJ,Peace Party,3582,0,3582,7
Uttar Pradesh,Maharajganj,MANGAL LAL,Lok Dal,1491,0,1491,8
Uttar Pradesh,Maharajganj,PASHUPATI NATH GUPTA,Aam Aadmi Party,3196,0,3196,9
Uttar Pradesh,Maharajganj,RADHEYSHYAM,MBCOI,1961,0,1961,10
Uttar Pradesh,Maharajganj,RAMSAMUJH,S(J),5001,0,5001,11
Uttar Pradesh,Maharajganj,VIMLESH TRIPATHI,NAP,2339,0,2339,12
Uttar Pradesh,Maharajganj,SHIVCHARAN,jhspt,3455,0,3455,13
Uttar Pradesh,Maharajganj,SHREE AKHILESH KUMAR,ADUP,5422,0,5422,14
Uttar Pradesh,Maharajganj,AJAYDHAR,Independent,4079,0,4079,15
Uttar Pradesh,Maharajganj,ANIL KUMAR SHAHANI,Independent,15517,0,15517,16
Uttar Pradesh,Maharajganj,GOVIND DAS,Independent,4216,0,4216,17
Uttar Pradesh,Maharajganj,TEJ PRATAP,Independent,6131,0,6131,18
Uttar Pradesh,Maharajganj,DAYARAM NISHAD,Independent,4210,0,4210,19
Uttar Pradesh,Maharajganj,DINESH KUMAR,Independent,1671,0,1671,20
Uttar Pradesh,Maharajganj,DINANATH,Independent,2149,0,2149,21
Uttar Pradesh,Maharajganj,RAKESH KUMAR GIRI,Independent,2545,0,2545,22
Uttar Pradesh,Maharajganj,RAKESH KUMAR GUPTA,Independent,1828,0,1828,23
Uttar Pradesh,Maharajganj,None of the Above,NOTA,4545,0,4545,24
Uttar Pradesh,Gorakhpur,ASTBHUJA PRASAD TRIPATHI,Indian National Congress,45693,26,45719,1
Uttar Pradesh,Gorakhpur,ADITYANATH,Bharatiya Janata Party,538604,523,539127,2
Uttar Pradesh,Gorakhpur,RAJMATI NISHAD,Samajwadi Party,226216,128,226344,3
Uttar Pradesh,Gorakhpur,RAM BHUAL NISHAD,Bahujan Samaj Party,176277,135,176412,4
Uttar Pradesh,Gorakhpur,INDRA DEO YADAVA,Bhartiya Shakti Chetna Party,2398,0,2398,5
Uttar Pradesh,Gorakhpur,FAIZ AHAMAD FAIZI,Peace Party,5045,1,5046,6
Uttar Pradesh,Gorakhpur,MUNNA,Swarajya Party Of India,4024,0,4024,7
Uttar Pradesh,Gorakhpur,RAJIT MISHRA,NAP,1170,1,1171,8
Uttar Pradesh,Gorakhpur,RAJESH,Communist Party of India (Marxist-Lenninist) (Liberation),1872,1,1873,9
Uttar Pradesh,Gorakhpur,RADHE MOHAN MISRA,Aam Aadmi Party,11844,29,11873,10
Uttar Pradesh,Gorakhpur,MOHD. WASEEM KHAN,Bahujan Mukti Party,2013,3,2016,11
Uttar Pradesh,Gorakhpur,SUBASH KUMAR MAURYA,Rashtriya Janwadi Party (Krantikari),2122,1,2123,12
Uttar Pradesh,Gorakhpur,ACHHE LAL GUPTA,Independent,5338,1,5339,13
Uttar Pradesh,Gorakhpur,ASHOK,Independent,4194,0,4194,14
Uttar Pradesh,Gorakhpur,RAMKISHUN,Independent,4387,0,4387,15
Uttar Pradesh,Gorakhpur,None of the Above,NOTA,8149,4,8153,16
Uttar Pradesh,Kushi Nagar,KUNWAR RATANJIT PRATAP NARAIN SINGH,Indian National Congress,284378,133,284511,1
Uttar Pradesh,Kushi Nagar,RAJESH PANDEY URF GUDDU,Bharatiya Janata Party,369917,134,370051,2
Uttar Pradesh,Kushi Nagar,RADHE SHYAM SINGH,Samajwadi Party,111218,38,111256,3
Uttar Pradesh,Kushi Nagar,DR. SANGAM MISHRA,Bahujan Samaj Party,132811,70,132881,4
Uttar Pradesh,Kushi Nagar,AKHAND,Aam Aadmi Party,3800,2,3802,5
Uttar Pradesh,Kushi Nagar,AMEERUDDIN,ADUP,3843,0,3843,6
Uttar Pradesh,Kushi Nagar,ARVIND,S(J),3630,0,3630,7
Uttar Pradesh,Kushi Nagar,KASHIM ALI,Peace Party,9022,2,9024,8
Uttar Pradesh,Kushi Nagar,GOBARDHAN PRASAD,Socialist Party (India),1963,0,1963,9
Uttar Pradesh,Kushi Nagar,JAHID,Suheldev Bhartiya Samaj Party,2677,0,2677,10
Uttar Pradesh,Kushi Nagar,BACHCHOOLAAL,MBCOI,2145,0,2145,11
Uttar Pradesh,Kushi Nagar,MARKANDE,Bahujan Mukti Party,4268,2,4270,12
Uttar Pradesh,Kushi Nagar,RAMDHANEE,DNP,5485,0,5485,13
Uttar Pradesh,Kushi Nagar,RAMPRATAP,Janata Dal (United),4805,1,4806,14
Uttar Pradesh,Kushi Nagar,None of the Above,NOTA,10102,0,10102,15
Uttar Pradesh,Deoria,KALRAJ MISHRA,Bharatiya Janata Party,495861,639,496500,1
Uttar Pradesh,Deoria,NIYAJ AHMAD,Bahujan Samaj Party,230862,252,231114,2
Uttar Pradesh,Deoria,BALESHWAR YADAV,Samajwadi Party,150687,165,150852,3
Uttar Pradesh,Deoria,SABHA KUNWAR,Indian National Congress,37713,39,37752,4
Uttar Pradesh,Deoria,AROON KUMAR TRIPATHI,Aam Aadmi Party,4939,13,4952,5
Uttar Pradesh,Deoria,AWADH KISHOR NIGAM,ARVP,1153,0,1153,6
Uttar Pradesh,Deoria,INTZARUL,Bahujan Mukti Party,1831,2,1833,7
Uttar Pradesh,Deoria,UMESH,Suheldev Bhartiya Samaj Party,4343,0,4343,8
Uttar Pradesh,Deoria,RAJU,MOP,5405,1,5406,9
Uttar Pradesh,Deoria,RAM PRAVESH,BED,6408,0,6408,10
Uttar Pradesh,Deoria,RAM PREET,MBCOI,1905,1,1906,11
Uttar Pradesh,Deoria,VED PRAKASH MALL,Janata Dal (United),1915,1,1916,12
Uttar Pradesh,Deoria,SHYAM SUNDAR,Peace Party,5130,0,5130,13
Uttar Pradesh,Deoria,BARKHA KINNAR,Independent,4123,1,4124,14
Uttar Pradesh,Deoria,HEMANT KISHOR SRIVASTAVA,Independent,5763,0,5763,15
Uttar Pradesh,Deoria,None of the Above,NOTA,12405,0,12405,16
Uttar Pradesh,Bansgaon,KAMLESH PASWAN,Bharatiya Janata Party,417597,362,417959,1
Uttar Pradesh,Bansgaon,GORAKH PRASAD PASWAN,Samajwadi Party,133534,141,133675,2
Uttar Pradesh,Bansgaon,SADAL PRASAD,Bahujan Samaj Party,228260,183,228443,3
Uttar Pradesh,Bansgaon,SANJAI KUMAR,Indian National Congress,50648,27,50675,4
Uttar Pradesh,Bansgaon,ARJUN PRASAD RAW,BaSaP,2896,0,2896,5
Uttar Pradesh,Bansgaon,CHANDRIKA PRASAD BHARATI,Rashtriya Janwadi Party (Krantikari),1327,0,1327,6
Uttar Pradesh,Bansgaon,RAMNARESH,ISSP,2963,0,2963,7
Uttar Pradesh,Bansgaon,RAMNIVAS  PASWAN,Aam Aadmi Party,5229,7,5236,8
Uttar Pradesh,Bansgaon,RAMPRIT JAKHMEE,Bahujan Mukti Party,3076,4,3080,9
Uttar Pradesh,Bansgaon,LALCHAND PRASAD JATAV,Ambedkar Samaj Party,9769,0,9769,10
Uttar Pradesh,Bansgaon,KUNJAWATI,Independent,4346,0,4346,11
Uttar Pradesh,Bansgaon,SHEO SHANKAR,Independent,4013,0,4013,12
Uttar Pradesh,Bansgaon,None of the Above,NOTA,13494,1,13495,13
Uttar Pradesh,Lalganj,NEELAM SONKAR,Bharatiya Janata Party,324004,12,324016,1
Uttar Pradesh,Lalganj,DR. BALIRAM,Bahujan Samaj Party,233961,10,233971,2
Uttar Pradesh,Lalganj,BALIHARI BABU,Indian National Congress,21832,0,21832,3
Uttar Pradesh,Lalganj,BECHAI SAROJ,Samajwadi Party,260912,18,260930,4
Uttar Pradesh,Lalganj,HARIPRASAD SONKAR,Communist Party of India,10523,0,10523,5
Uttar Pradesh,Lalganj,JIYA LAL,Aam Aadmi Party,5668,0,5668,6
Uttar Pradesh,Lalganj,DINESH KUMAR,Aa S P,1733,0,1733,7
Uttar Pradesh,Lalganj,PRADEEP KUMAR,Rashtriya Ulama Council,14368,0,14368,8
Uttar Pradesh,Lalganj,LAL BAHADUR,Bahujan Mukti Party,1911,0,1911,9
Uttar Pradesh,Lalganj,SHRIPATI,Quami Ekta Dal,4620,0,4620,10
Uttar Pradesh,Lalganj,SUKHANAYAN,JSEP,1398,0,1398,11
Uttar Pradesh,Lalganj,ACHCHHELAL,Independent,4536,0,4536,12
Uttar Pradesh,Lalganj,AVADHESH,Independent,2129,0,2129,13
Uttar Pradesh,Lalganj,JANGBAHADUR,Independent,3307,0,3307,14
Uttar Pradesh,Lalganj,None of the Above,NOTA,7713,0,7713,15
Uttar Pradesh,Azamgarh,ARVIND KUMAR JAISWAL,Indian National Congress,17947,3,17950,1
Uttar Pradesh,Azamgarh,MULAYAM SINGH YADAV,Samajwadi Party,340084,222,340306,2
Uttar Pradesh,Azamgarh,RAMAKANT YADAV,Bharatiya Janata Party,276998,104,277102,3
Uttar Pradesh,Azamgarh,SHAH ALAM ALIAS GUDDU JAMALI,Bahujan Samaj Party,266397,131,266528,4
Uttar Pradesh,Azamgarh,M. AMIR RASHADI,Rashtriya Ulama Council,13270,1,13271,5
Uttar Pradesh,Azamgarh,KIRAN SHARAMA,Bhartiya Shakti Chetna Party,1298,0,1298,6
Uttar Pradesh,Azamgarh,DURG VIJAY YADAV,Bahujan Mukti Party,1566,0,1566,7
Uttar Pradesh,Azamgarh,PRAKASH CHANDRA,ssrd,2103,0,2103,8
Uttar Pradesh,Azamgarh,MADAN,All India Trinamool Congress,5207,0,5207,9
Uttar Pradesh,Azamgarh,RAJDHARI RAJBHAR,MOSP,1695,0,1695,10
Uttar Pradesh,Azamgarh,RAJESH YADAV,Aam Aadmi Party,3080,2,3082,11
Uttar Pradesh,Azamgarh,SANJAY KUMAR CHATURVEDI,ISSP,4051,0,4051,12
Uttar Pradesh,Azamgarh,SANTOSH KUMAR GAUTAM,MwSP,3866,0,3866,13
Uttar Pradesh,Azamgarh,PRAMOD SINGH,Independent,3752,0,3752,14
Uttar Pradesh,Azamgarh,RAM SINGH CHAUHAN,Independent,2507,0,2507,15
Uttar Pradesh,Azamgarh,SHAMSHAD AHMAD,Independent,4875,0,4875,16
Uttar Pradesh,Azamgarh,SUGRIV CHAUHAN,Independent,1882,0,1882,17
Uttar Pradesh,Azamgarh,SANJAY CHAUHAN,Independent,3517,0,3517,18
Uttar Pradesh,Azamgarh,None of the Above,NOTA,5660,0,5660,19
Uttar Pradesh,Ghosi,ATUL KUMAR SINGH ANJAAN,Communist Party of India,18162,0,18162,1
Uttar Pradesh,Ghosi,DARA SINGH CHAUHAN,Bahujan Samaj Party,233739,43,233782,2
Uttar Pradesh,Ghosi,RAJEEV KUMAR RAI,Samajwadi Party,165855,32,165887,3
Uttar Pradesh,Ghosi,RASHTRA KUNWAR SINGH,Indian National Congress,19312,3,19315,4
Uttar Pradesh,Ghosi,HARINARAYAN RAJBHAR,Bharatiya Janata Party,379739,58,379797,5
Uttar Pradesh,Ghosi,BADRI NATH YADAV,RaCP,7650,0,7650,6
Uttar Pradesh,Ghosi,MANISH KUMAR RAI,Aam Aadmi Party,4186,2,4188,7
Uttar Pradesh,Ghosi,MOKHTAR ANSARI,Quami Ekta Dal,166436,7,166443,8
Uttar Pradesh,Ghosi,RAVI SHANKAR BHARAT,JaRaP,2543,0,2543,9
Uttar Pradesh,Ghosi,RAJKUMAR CHAUHAN,Jan Parishad,2246,0,2246,10
Uttar Pradesh,Ghosi,VIJAY KUMAR UPADHYAY,Rashtriya Krantikari Samajwadi Party,3826,0,3826,11
Uttar Pradesh,Ghosi,DR. SHAMEEM ABIDI,Peace Party,7581,0,7581,12
Uttar Pradesh,Ghosi,HARINATH,NAP,1786,0,1786,13
Uttar Pradesh,Ghosi,HARISH CHANDRA,Rashtriya Janwadi Party (Krantikari),4130,0,4130,14
Uttar Pradesh,Ghosi,HEMANT KUMAR,BaSaP,2949,0,2949,15
Uttar Pradesh,Ghosi,DOODHNATH CHAUHAN,Independent,8163,0,8163,16
Uttar Pradesh,Ghosi,VISHUN DAYAL,Independent,2721,0,2721,17
Uttar Pradesh,Ghosi,SURYA KUMAR,Independent,4030,0,4030,18
Uttar Pradesh,Ghosi,None of the Above,NOTA,4457,0,4457,19
Uttar Pradesh,Salempur,DR.BHOLA PANDEY,Indian National Congress,41839,51,41890,1
Uttar Pradesh,Salempur,RAVINDRA KUSHAWAHA,Bharatiya Janata Party,391636,577,392213,2
Uttar Pradesh,Salempur,"RAVI SHANKER SINGH""PAPPU""",Bahujan Samaj Party,159580,291,159871,3
Uttar Pradesh,Salempur,HARIBANSH SAHAI KUSHWAHA,Samajwadi Party,159453,235,159688,4
Uttar Pradesh,Salempur,ONKAR SINGH,SaSaP,4946,1,4947,5
Uttar Pradesh,Salempur,OM PRAKASH RAJBHAR,Suheldev Bhartiya Samaj Party,66068,16,66084,6
Uttar Pradesh,Salempur,CHANDRA PRATAP SINGH,Aam Aadmi Party,4251,12,4263,7
Uttar Pradesh,Salempur,FIROZ AKHTAR,Rashtriya Ulama Council,1506,1,1507,8
Uttar Pradesh,Salempur,SHRIRAM CHAUDHARY,Communist Party of India (Marxist-Lenninist) (Liberation),3572,0,3572,9
Uttar Pradesh,Salempur,DR SANJAY KR. SINGH,Janata Dal (United),1674,1,1675,10
Uttar Pradesh,Salempur,RAM KRIPAL,Independent,4377,0,4377,11
Uttar Pradesh,Salempur,SIYARAM DAS,Independent,2709,0,2709,12
Uttar Pradesh,Salempur,SUSHANT RAJ PATHAK,Independent,3630,1,3631,13
Uttar Pradesh,Salempur,None of the Above,NOTA,8320,2,8322,14
Uttar Pradesh,Ballia,NEERAJ SHEKHAR,Samajwadi Party,220089,235,220324,1
Uttar Pradesh,Ballia,BHARAT SINGH,Bharatiya Janata Party,359329,429,359758,2
Uttar Pradesh,Ballia,VIRENDRA KUMAR PATHAK,Bahujan Samaj Party,141471,213,141684,3
Uttar Pradesh,Ballia,SUDHA RAI,Indian National Congress,13486,15,13501,4
Uttar Pradesh,Ballia,AFZAL ANSARI,Quami Ekta Dal,163820,123,163943,5
Uttar Pradesh,Ballia,AVADHESH VERMA,Bahujan Mukti Party,2527,2,2529,6
Uttar Pradesh,Ballia,COL(RETD) BHARAT SINGH SHAURYA CHAKRA,Aam Aadmi Party,3289,8,3297,7
Uttar Pradesh,Ballia,MANNU YADAV,NAP,980,0,980,8
Uttar Pradesh,Ballia,RAMJI,Bharatiya Samaj Dal,1096,0,1096,9
Uttar Pradesh,Ballia,RAMROOP,jhspt,6435,0,6435,10
Uttar Pradesh,Ballia,SUCHIT GOND,Gondvana Gantantra Party,2505,1,2506,11
Uttar Pradesh,Ballia,BHOLA NATH,Independent,2814,1,2815,12
Uttar Pradesh,Ballia,MANISH,Independent,6165,1,6166,13
Uttar Pradesh,Ballia,MANOJ,Independent,6833,0,6833,14
Uttar Pradesh,Ballia,SHESHNATH,Independent,3674,0,3674,15
Uttar Pradesh,Ballia,None of the Above,NOTA,6669,1,6670,16
Uttar Pradesh,Jaunpur,KRISHNA PRATAP ''''''''K.P.'''''''',Bharatiya Janata Party,366856,293,367149,1
Uttar Pradesh,Jaunpur,PARASNATH YADAV,Samajwadi Party,179834,169,180003,2
Uttar Pradesh,Jaunpur,RAVI KISHAN,Indian National Congress,42749,10,42759,3
Uttar Pradesh,Jaunpur,SUBHASH PANDEY,Bahujan Samaj Party,220625,214,220839,4
Uttar Pradesh,Jaunpur,ANUPATI RAM YADAV,Bahujan Mukti Party,4023,3,4026,5
Uttar Pradesh,Jaunpur,ARVIND,Suheldev Bhartiya Samaj Party,2204,0,2204,6
Uttar Pradesh,Jaunpur,GULAB CHAND DUBEY,Shivsena,1751,0,1751,7
Uttar Pradesh,Jaunpur,PRAMOD KUMAR ALIAS PRAMOD BHAI PATEL,SPP,7206,0,7206,8
Uttar Pradesh,Jaunpur,PREMCHAND BIND,Pragatisheel Manav Samaj Party,6814,0,6814,9
Uttar Pradesh,Jaunpur,DR. K. P. YADAV,Aam Aadmi Party,43397,74,43471,10
Uttar Pradesh,Jaunpur,RAVISHANKAR MAURYA,SOCIALIST UNITY CENTRE OF INDIA (COMMUNIST),2607,1,2608,11
Uttar Pradesh,Jaunpur,RAJESH PRAJAPATI,SaDa,2329,0,2329,12
Uttar Pradesh,Jaunpur,SHAHABUDDIN,Rashtriya Ulama Council,19633,3,19636,13
Uttar Pradesh,Jaunpur,SARFARAJ,Peace Party,2063,1,2064,14
Uttar Pradesh,Jaunpur,ANIL KUMAR SINGH,Independent,2694,0,2694,15
Uttar Pradesh,Jaunpur,JOGENDRA PRASAD,Independent,7281,0,7281,16
Uttar Pradesh,Jaunpur,DHANANJAY SINGH,Independent,64093,44,64137,17
Uttar Pradesh,Jaunpur,YOGISH CHANDRA DUBEY,Independent,2773,0,2773,18
Uttar Pradesh,Jaunpur,RAVIKANT YADAV,Independent,20819,13,20832,19
Uttar Pradesh,Jaunpur,VIMAL KUMAR YADAV,Independent,2109,0,2109,20
Uttar Pradesh,Jaunpur,DR. SANJIVAN BIND,Independent,1863,0,1863,21
Uttar Pradesh,Jaunpur,None of the Above,NOTA,2594,1,2595,22
Uttar Pradesh,Machhlishahr,TUFANI,Samajwadi Party,191175,212,191387,1
Uttar Pradesh,Machhlishahr,TUFANI NISHAD,Indian National Congress,36258,17,36275,2
Uttar Pradesh,Machhlishahr,BHOLANATH ALIAS B.P. SAROJ,Bahujan Samaj Party,265700,355,266055,3
Uttar Pradesh,Machhlishahr,RAM CHARITRA NISHAD,Bharatiya Janata Party,437723,487,438210,4
Uttar Pradesh,Machhlishahr,SUBAS CHANDRA,Communist Party of India,18775,2,18777,5
Uttar Pradesh,Machhlishahr,RAJ ALIAS VIRENDRA KUMAR SONKAR,Aam Aadmi Party,9200,23,9223,6
Uttar Pradesh,Machhlishahr,RAJESH,Janata Dal (United),1552,0,1552,7
Uttar Pradesh,Machhlishahr,LALJI,Bhartiya Shakti Chetna Party,1542,1,1543,8
Uttar Pradesh,Machhlishahr,SIKANDAR,Bahujan Mukti Party,2108,6,2114,9
Uttar Pradesh,Machhlishahr,SURESH GAUTAM,ARVP,1467,0,1467,10
Uttar Pradesh,Machhlishahr,HARI,Suheldev Bhartiya Samaj Party,2668,1,2669,11
Uttar Pradesh,Machhlishahr,OMPRAKASH ALIAS AMBEDKAR,Independent,2706,2,2708,12
Uttar Pradesh,Machhlishahr,RAJESH SONKAR,Independent,4362,0,4362,13
Uttar Pradesh,Machhlishahr,SHRAVAN KUMAR PASWAN,Independent,7833,0,7833,14
Uttar Pradesh,Machhlishahr,HARINATH,Independent,5278,1,5279,15
Uttar Pradesh,Machhlishahr,None of the Above,NOTA,8446,2,8448,16
Uttar Pradesh,Ghazipur,KAILASH NATH SINGH YADAV,Bahujan Samaj Party,241542,103,241645,1
Uttar Pradesh,Ghazipur,MO. MAKSUD KHAN,Indian National Congress,18904,4,18908,2
Uttar Pradesh,Ghazipur,MANOJ SINHA,Bharatiya Janata Party,306791,138,306929,3
Uttar Pradesh,Ghazipur,SMT SHIVKANYA KUSHWAHA,Samajwadi Party,274337,140,274477,4
Uttar Pradesh,Ghazipur,ISHWAR DEV,ARVP,4018,1,4019,5
Uttar Pradesh,Ghazipur,ISHWARI,Communist Party of India (Marxist-Lenninist) (Liberation),6512,0,6512,6
Uttar Pradesh,Ghazipur,OMKAR CHAUHAN,Jan Parishad,2416,0,2416,7
Uttar Pradesh,Ghazipur,GUPTESHWAR,Lok Dal,1111,0,1111,8
Uttar Pradesh,Ghazipur,DEENDAYAL,Pragatisheel Manav Samaj Party,2122,0,2122,9
Uttar Pradesh,Ghazipur,DHARM YADAV ALIAS D.P.YADAV,Rashtriya Parivartan Dal,59502,8,59510,10
Uttar Pradesh,Ghazipur,PAPPU,EKSP,3584,1,3585,11
Uttar Pradesh,Ghazipur,BRIJ BHUSHAN,Aam Aadmi Party,6917,8,6925,12
Uttar Pradesh,Ghazipur,BHARAT,JRPa,2483,1,2484,13
Uttar Pradesh,Ghazipur,RAJENDRA NATH RAM,Bahujan Mukti Party,3468,0,3468,14
Uttar Pradesh,Ghazipur,SATYA DEV YADAV,NAP,6381,0,6381,15
Uttar Pradesh,Ghazipur,ARUN KUMAR SINGH,Independent,34084,9,34093,16
Uttar Pradesh,Ghazipur,KUBER,Independent,4889,0,4889,17
Uttar Pradesh,Ghazipur,LAKSHAMAN,Independent,1588,0,1588,18
Uttar Pradesh,Ghazipur,None of the Above,NOTA,5610,1,5611,19
Uttar Pradesh,Chandauli,ANIL KUMAR MAURYA,Bahujan Samaj Party,257200,179,257379,1
Uttar Pradesh,Chandauli,TARUN PATEL URF TARUNENDRA CHAND PATEL,Indian National Congress,27182,12,27194,2
Uttar Pradesh,Chandauli,DR MAHENDRA NATH PANDEY,Bharatiya Janata Party,413760,375,414135,3
Uttar Pradesh,Chandauli,RAMKISHUN,Samajwadi Party,204036,109,204145,4
Uttar Pradesh,Chandauli,IRSHAD,Aam Aadmi Party,15583,15,15598,5
Uttar Pradesh,Chandauli,CHANCHAL,JRPa,1362,0,1362,6
Uttar Pradesh,Chandauli,JITENDRA,Gondvana Gantantra Party,2502,0,2502,7
Uttar Pradesh,Chandauli,MRITUNJAYA PANDEY,JaRaPa,1318,0,1318,8
Uttar Pradesh,Chandauli,RAMASHANKER SINGH MAURYA,BSKD,1423,0,1423,9
Uttar Pradesh,Chandauli,RAJA JAISWAL,All India Trinamool Congress,6169,1,6170,10
Uttar Pradesh,Chandauli,RAJENDRA,Pragatisheel Manav Samaj Party,7767,0,7767,11
Uttar Pradesh,Chandauli,RAM DULAR,Communist Party of India (Marxist-Lenninist) (Liberation),2386,0,2386,12
Uttar Pradesh,Chandauli,DR. VINAY KUMAR SINGH YADAV,Indian National League,3881,1,3882,13
Uttar Pradesh,Chandauli,SHASHI SINHA,ESKP,2987,1,2988,14
Uttar Pradesh,Chandauli,SANJEEV SINGH,Suheldev Bhartiya Samaj Party,4992,1,4993,15
Uttar Pradesh,Chandauli,DR. HARIDWAR SINGH YADAV,Janata Dal (United),8755,1,8756,16
Uttar Pradesh,Chandauli,HEERALAL,Bahujan Mukti Party,4766,2,4768,17
Uttar Pradesh,Chandauli,GULVAS,Independent,1482,0,1482,18
Uttar Pradesh,Chandauli,BINDU,Independent,2769,0,2769,19
Uttar Pradesh,Chandauli,RAJNARAYAN,Independent,4221,0,4221,20
Uttar Pradesh,Chandauli,SANJAI,Independent,2148,0,2148,21
Uttar Pradesh,Chandauli,None of the Above,NOTA,3184,2,3186,22
Uttar Pradesh,Varanasi,AJAY RAI,Indian National Congress,75541,73,75614,1
Uttar Pradesh,Varanasi,KAILASH CHAURASIYA,Samajwadi Party,45266,25,45291,2
Uttar Pradesh,Varanasi,NARENDRA MODI,Bharatiya Janata Party,580423,599,581022,3
Uttar Pradesh,Varanasi,VIJAY PRAKASH JAISAWAL,Bahujan Samaj Party,60534,45,60579,4
Uttar Pradesh,Varanasi,HIRALAL YADAV,Communist Party of India  (Marxist),2457,0,2457,5
Uttar Pradesh,Varanasi,A.K. AGGARWAL,Agar Jan Party,2037,0,2037,6
Uttar Pradesh,Varanasi,ABHIMANYU SINGH PATEL,Bahujan Mukti Party,1644,0,1644,7
Uttar Pradesh,Varanasi,ARVIND KEJRIWAL,Aam Aadmi Party,209111,127,209238,8
Uttar Pradesh,Varanasi,ARUN,Bhartiya Shakti Chetna Party,3634,0,3634,9
Uttar Pradesh,Varanasi,INDIRA TIWARI,All India Trinamool Congress,2674,0,2674,10
Uttar Pradesh,Varanasi,USMAN,RsAD,878,0,878,11
Uttar Pradesh,Varanasi,OM GURU CHARAN DAS ALIAS VIMAL KUMAR SINGH,ssrd,1144,0,1144,12
Uttar Pradesh,Varanasi,DEVI PRASAD NAND,MADP,1740,0,1740,13
Uttar Pradesh,Varanasi,NARENDRA NATH DUBEY ADIG,JSEP,2277,0,2277,14
Uttar Pradesh,Varanasi,BACHCHELAL,LPSP,1172,0,1172,15
Uttar Pradesh,Varanasi,RAJESH BHARTI SURYA,RaAD,4327,0,4327,16
Uttar Pradesh,Varanasi,RAM LAKHAN GUPTA,JAP,1376,0,1376,17
Uttar Pradesh,Varanasi,LALLAN,MaJP,997,0,997,18
Uttar Pradesh,Varanasi,SHIVHARI AGARWAL,BhNP,2000,0,2000,19
Uttar Pradesh,Varanasi,SANTOSH KUMAR,RVMP,1434,0,1434,20
Uttar Pradesh,Varanasi,HARI LAL,RaIP,838,0,838,21
Uttar Pradesh,Varanasi,HEMANT KUMAR YADAV,Indian National League,1202,0,1202,22
Uttar Pradesh,Varanasi,AHMED SOHEL SIDDIQUI,Independent,937,0,937,23
Uttar Pradesh,Varanasi,IFTEKHAR KURAISHI,Independent,2323,0,2323,24
Uttar Pradesh,Varanasi,GHANSHYAM,Independent,1151,0,1151,25
Uttar Pradesh,Varanasi,JOHNSON THOMAS,Independent,1524,0,1524,26
Uttar Pradesh,Varanasi,NARENDRA BAHADUR SINGH,Independent,1306,0,1306,27
Uttar Pradesh,Varanasi,PRAKASH PRASAD,Independent,1361,0,1361,28
Uttar Pradesh,Varanasi,PRABHAT KUMAR,Independent,1089,0,1089,29
Uttar Pradesh,Varanasi,PRAMOD KUMAR,Independent,1807,0,1807,30
Uttar Pradesh,Varanasi,BACHCHAN PRASAD YADAV,Independent,1192,0,1192,31
Uttar Pradesh,Varanasi,BASEER KINNAR,Independent,2850,0,2850,32
Uttar Pradesh,Varanasi,MANOJ KUMAR CHAUBEY,Independent,1074,0,1074,33
Uttar Pradesh,Varanasi,MAHENDRA MISHRA,Independent,573,0,573,34
Uttar Pradesh,Varanasi,RAVINDRA KUMAR,Independent,1012,0,1012,35
Uttar Pradesh,Varanasi,RAJIV KUMAR MISHRA,Independent,677,0,677,36
Uttar Pradesh,Varanasi,RAJENDRA PRASAD (GARIB DAS),Independent,1367,0,1367,37
Uttar Pradesh,Varanasi,RAMPYARE SINGH,Independent,423,0,423,38
Uttar Pradesh,Varanasi,SHIV KUMAR SHAH,Independent,312,0,312,39
Uttar Pradesh,Varanasi,SATISH SHANKAR JAYASWAL,Independent,459,0,459,40
Uttar Pradesh,Varanasi,SATYAPRAKASH SRIVASTAVA,Independent,599,0,599,41
Uttar Pradesh,Varanasi,SARVESH KUMAR GUPTA,Independent,3023,0,3023,42
Uttar Pradesh,Varanasi,None of the Above,NOTA,2051,0,2051,43
Uttar Pradesh,Bhadohi,DR. AKHILESH KUMAR DWIVEDI,Nationalist Congress Party,7732,2,7734,1
Uttar Pradesh,Bhadohi,RAKESH DHAR TRIPATHI,Bahujan Samaj Party,245437,117,245554,2
Uttar Pradesh,Bhadohi,VIRENDRA SINGH,Bharatiya Janata Party,403583,112,403695,3
Uttar Pradesh,Bhadohi,SARTAJ IMAM,Indian National Congress,22569,4,22573,4
Uttar Pradesh,Bhadohi,SEEMA MISHRA,Samajwadi Party,238570,142,238712,5
Uttar Pradesh,Bhadohi,AJAY KUMAR MAURYA,Pragatisheel Manav Samaj Party,5807,1,5808,6
Uttar Pradesh,Bhadohi,TEJ BAHADUR YADAV ADVOCATE,Janata Dal (United),26985,10,26995,7
Uttar Pradesh,Bhadohi,RAJESH KUMAR ALIAS KHANNA MAURYA,AMP,1920,0,1920,8
Uttar Pradesh,Bhadohi,RAM SAGAR BIND,Quami Ekta Dal,2440,2,2442,9
Uttar Pradesh,Bhadohi,CHANDRASHEKHAR,Independent,2191,0,2191,10
Uttar Pradesh,Bhadohi,JAGJEEVAN RAM ALIAS JEEVAN RAM ,Independent,1964,0,1964,11
Uttar Pradesh,Bhadohi,JEEVAN KUMAR MALLAH,Independent,4168,1,4169,12
Uttar Pradesh,Bhadohi,RAM SAKHA TRIPATHI,Independent,4319,0,4319,13
Uttar Pradesh,Bhadohi,SANTRAJ SINGH,Independent,4821,0,4821,14
Uttar Pradesh,Bhadohi,None of the Above,NOTA,8968,1,8969,15
Uttar Pradesh,Mirzapur,LALITESH PATI TRIPATHI,Indian National Congress,152663,3,152666,1
Uttar Pradesh,Mirzapur,SAMUDRA BIND,Bahujan Samaj Party,217452,5,217457,2
Uttar Pradesh,Mirzapur,SURENDRA SINGH PATEL,Samajwadi Party,108858,1,108859,3
Uttar Pradesh,Mirzapur,ANUPRIYA SINGH PATEL,Apna Dal,436500,36,436536,4
Uttar Pradesh,Mirzapur,AJAD,Gondvana Gantantra Party,6762,0,6762,5
Uttar Pradesh,Mirzapur,JITTOO RAM RATNA,Lok Dal,4209,0,4209,6
Uttar Pradesh,Mirzapur,JEERA BHARTI,Communist Party of India (Marxist-Lenninist) (Liberation),4148,0,4148,7
Uttar Pradesh,Mirzapur,BRIJESH KUMAR RAI,Aam Aadmi Party,4317,1,4318,8
Uttar Pradesh,Mirzapur,BHAGWAN DAS,Bahujan Mukti Party,3324,0,3324,9
Uttar Pradesh,Mirzapur,RADHESHYAM INSAN,BRPI,2138,0,2138,10
Uttar Pradesh,Mirzapur,VINEET SAHAI,All India Trinamool Congress,4548,0,4548,11
Uttar Pradesh,Mirzapur,SHIVRAJ SAHNI,Pragatisheel Manav Samaj Party,4405,0,4405,12
Uttar Pradesh,Mirzapur,SANTOSH KUMAR,SPP,6811,0,6811,13
Uttar Pradesh,Mirzapur,SARVESH DUBEY,Republican Party of India (A),4304,0,4304,14
Uttar Pradesh,Mirzapur,SUKCHARA NAND URF AALOO BABA,Shivsena,4787,0,4787,15
Uttar Pradesh,Mirzapur,ASHOK KUMAR,Independent,11245,0,11245,16
Uttar Pradesh,Mirzapur,ADESH TYAGI,Independent,3300,0,3300,17
Uttar Pradesh,Mirzapur,DR. KARNAIL SINGH,Independent,3627,0,3627,18
Uttar Pradesh,Mirzapur,GIRJA SHANKAR URF CHUNMUN,Independent,2363,0,2363,19
Uttar Pradesh,Mirzapur,DEVI,Independent,4639,0,4639,20
Uttar Pradesh,Mirzapur,RAJA RAM,Independent,2010,0,2010,21
Uttar Pradesh,Mirzapur,RAM MURAT,Independent,7947,0,7947,22
Uttar Pradesh,Mirzapur,HINCH LAL,Independent,2685,0,2685,23
Uttar Pradesh,Mirzapur,None of the Above,NOTA,4539,0,4539,24
Uttar Pradesh,Robertsganj,ASHOK KUMAR KANNAOUJIYA,Communist Party of India,24362,1,24363,1
Uttar Pradesh,Robertsganj,CHHOTELAL,Bharatiya Janata Party,378095,116,378211,2
Uttar Pradesh,Robertsganj,PAKAUDI LAL KOL,Samajwadi Party,135916,50,135966,3
Uttar Pradesh,Robertsganj,BHAGWATI PRASAD CHAUDHARY,Indian National Congress,86234,1,86235,4
Uttar Pradesh,Robertsganj,SHARADA PRASAD,Bahujan Samaj Party,187652,73,187725,5
Uttar Pradesh,Robertsganj,GUN DEVI ( GYANI DEVI),Quami Ekta Dal,5307,0,5307,6
Uttar Pradesh,Robertsganj,S. R. DARAPURI,AIPF,4890,1,4891,7
Uttar Pradesh,Robertsganj,MANGOI,Bahujan Mukti Party,2966,0,2966,8
Uttar Pradesh,Robertsganj,RAVI SHANKAR KANNAUJIA,Aam Aadmi Party,9912,1,9913,9
Uttar Pradesh,Robertsganj,RAJKUMAR,shsap,2980,2,2982,10
Uttar Pradesh,Robertsganj,SHANKAR KOL,Communist Party of India (Marxist-Lenninist) (Liberation),6101,0,6101,11
Uttar Pradesh,Robertsganj,ARUN SINGH(CHERO),Independent,5613,0,5613,12
Uttar Pradesh,Robertsganj,RAMBRIKSHA,Independent,9408,0,9408,13
Uttar Pradesh,Robertsganj,LAWRENCE ANTHONY,Independent,7703,0,7703,14
Uttar Pradesh,Robertsganj,None of the Above,NOTA,18489,0,18489,15
West Bengal,Cooch behar,KESHAB CHANDRA RAY,Indian National Congress,74453,87,74540,1
West Bengal,Cooch behar,GIRINDRA NATH BARMAN,Bahujan Samaj Party,15678,5,15683,2
West Bengal,Cooch behar,DIPAK KUMAR ROY,All India Forward Bloc,437987,1405,439392,3
West Bengal,Cooch behar,RENUKA SINHA,All India Trinamool Congress,525275,1224,526499,4
West Bengal,Cooch behar,HEM CHANDRA BARMAN,Bharatiya Janata Party,217193,460,217653,5
West Bengal,Cooch behar,KAMAL KRISHNA BAIRAGI,Rashtriya Janadhikar Suraksha Party,7123,2,7125,6
West Bengal,Cooch behar,DALENDRA NATH RAY,Amra Bangalee,4166,3,4169,7
West Bengal,Cooch behar,NRIPEN KARJEE,SOCIALIST UNITY CENTRE OF INDIA (COMMUNIST),6732,10,6742,8
West Bengal,Cooch behar,PIJUSH BARMAN,Welfare Party of India,5133,4,5137,9
West Bengal,Cooch behar,HAREKRISHNA SARKAR,Republican Party of India (A),5792,4,5796,10
West Bengal,Cooch behar,BANGSHI BADAN BARMAN,Independent,13189,16,13205,11
West Bengal,Cooch behar,HITENDRA DAS,Independent,5055,4,5059,12
West Bengal,Cooch behar,None of the Above,NOTA,11357,52,11409,13
West Bengal,Alipurduars,ELIASH NARJINARY,Bahujan Samaj Party,11036,3,11039,1
West Bengal,Alipurduars,DASRATH TIRKEY,All India Trinamool Congress,361685,768,362453,2
West Bengal,Alipurduars,BIRENDRA BARA (ORAON),Bharatiya Janata Party,335410,447,335857,3
West Bengal,Alipurduars,MANOHAR TIRKEY,Revolutionary Socialist Party,340119,937,341056,4
West Bengal,Alipurduars,JOSEPH MUNDA,Indian National Congress,116618,100,116718,5
West Bengal,Alipurduars,ISHABELA KUJUR,Rashtriya Janadhikar Suraksha Party,5961,0,5961,6
West Bengal,Alipurduars,BILKAN BARA,Samajwadi Jan Parishad,5339,1,5340,7
West Bengal,Alipurduars,SUBASH CHIK BARAIK,SOCIALIST UNITY CENTRE OF INDIA (COMMUNIST),7123,8,7131,8
West Bengal,Alipurduars,DR. KAPIN CH. BORO,Independent,7675,1,7676,9
West Bengal,Alipurduars,PAUL DEXION KHARIYA,Independent,10445,5,10450,10
West Bengal,Alipurduars,None of the Above,NOTA,19859,26,19885,11
West Bengal,Jalpaiguri,KSHITISH CHANDRA MANDAL,Bahujan Samaj Party,12143,4,12147,1
West Bengal,Jalpaiguri,BIJOY CHANDRA BARMAN,All India Trinamool Congress,493913,860,494773,2
West Bengal,Jalpaiguri,MAHENDRA KUMAR ROY,Communist Party of India  (Marxist),423965,1202,425167,3
West Bengal,Jalpaiguri,SATYALAL SARKAR,Bharatiya Janata Party,221326,267,221593,4
West Bengal,Jalpaiguri,SUKHBILAS BARMA,Indian National Congress,87472,116,87588,5
West Bengal,Jalpaiguri,DILIP SARKAR,Bahujan Mukti Party,4900,0,4900,6
West Bengal,Jalpaiguri,DHIRENDRA NATH ROY,Amra Bangalee,2834,1,2835,7
West Bengal,Jalpaiguri,DHRITIMAN ROY,Rashtriya Janadhikar Suraksha Party,4500,1,4501,8
West Bengal,Jalpaiguri,HARIPADA BARMAN,Rashtriya Janasachetan Party (R.J.P.),6605,3,6608,9
West Bengal,Jalpaiguri,HARIBHAKTA SARDAR,SOCIALIST UNITY CENTRE OF INDIA (COMMUNIST),9278,5,9283,10
West Bengal,Jalpaiguri,HAREKRISHNA SARKAR,Republican Party of India (A),7634,2,7636,11
West Bengal,Jalpaiguri,SUBHAS BISWAS,Independent,8544,1,8545,12
West Bengal,Jalpaiguri,None of the Above,NOTA,16506,35,16541,13
West Bengal,Darjeeling,S.S.AHLUWALIA,Bharatiya Janata Party,487864,393,488257,1
West Bengal,Darjeeling,KAKALI MAJUMDAR (ROY),Bahujan Samaj Party,6039,1,6040,2
West Bengal,Darjeeling,BHAI CHUNG BHUTIA,All India Trinamool Congress,290769,249,291018,3
West Bengal,Darjeeling,SAMAN PATHAK (SURAJ),Communist Party of India  (Marxist),167069,117,167186,4
West Bengal,Darjeeling,SUJAY GHATAK,Indian National Congress,89993,83,90076,5
West Bengal,Darjeeling,GOUTAM BHATTACHARYA,SOCIALIST UNITY CENTRE OF INDIA (COMMUNIST),3991,2,3993,6
West Bengal,Darjeeling,NIRANJAN SAHA,Amra Bangalee,2027,2,2029,7
West Bengal,Darjeeling,NIMA LAMA,grac,2886,20,2906,8
West Bengal,Darjeeling,LALIT SINGHA,Bahujan Mukti Party,2100,0,2100,9
West Bengal,Darjeeling,SUNIL PANDIT,Rashtriya Janasachetan Party (R.J.P.),3043,0,3043,10
West Bengal,Darjeeling,ARUN KUMAR AGARWAL,Independent,5448,1,5449,11
West Bengal,Darjeeling,MAHENDRA P. LAMA,Independent,55547,220,55767,12
West Bengal,Darjeeling,RABINDRA ROY BASUNIA,Independent,6099,1,6100,13
West Bengal,Darjeeling,None of the Above,NOTA,18032,13,18045,14
West Bengal,Raiganj,DEEPA DASMUNSI,Indian National Congress,315507,374,315881,1
West Bengal,Raiganj,NIMU BHOWMICK,Bharatiya Janata Party,202868,263,203131,2
West Bengal,Raiganj,PABITRA RANJAN DASMUNSHI (SATYA),All India Trinamool Congress,192408,290,192698,3
West Bengal,Raiganj,MD. SALIM,Communist Party of India  (Marxist),316863,652,317515,4
West Bengal,Raiganj,SWAPAN KUMAR DAS,Bahujan Samaj Party,5627,2,5629,5
West Bengal,Raiganj,ZAMEERUL HASAN,AIUDF,3470,1,3471,6
West Bengal,Raiganj,DULAL RAJBANSHI,SOCIALIST UNITY CENTRE OF INDIA (COMMUNIST),8591,1,8592,7
West Bengal,Raiganj,NANDAKISHOR SINGHA,Amra Bangalee,3335,3,3338,8
West Bengal,Raiganj,PASARUL ALAM,Aam Aadmi Party,3610,4,3614,9
West Bengal,Raiganj,BABLU SOREN,JDP,5541,3,5544,10
West Bengal,Raiganj,SUDIIP RANJAN SEN,Samajwadi Party,32295,8,32303,11
West Bengal,Raiganj,SUBRATA ADHIKARY,Independent,5548,0,5548,12
West Bengal,Raiganj,None of the Above,NOTA,10923,6,10929,13
West Bengal,Balurghat,ARPITA GHOSH,All India Trinamool Congress,408857,784,409641,1
West Bengal,Balurghat,OM PRAKAS MISHRA,Indian National Congress,80640,75,80715,2
West Bengal,Balurghat,BIMALENDU SARKAR (BIMAL),Revolutionary Socialist Party,302071,606,302677,3
West Bengal,Balurghat,BISWAPRIYA ROY CHOUDHURY,Bharatiya Janata Party,222535,479,223014,4
West Bengal,Balurghat,RAJEN HANSDA,Bahujan Samaj Party,4578,3,4581,5
West Bengal,Balurghat,ABDUS SADEK SARKAR,AIUDF,10545,2,10547,6
West Bengal,Balurghat,ISLAM NURAL,SOCIALIST UNITY CENTRE OF INDIA (COMMUNIST),2644,0,2644,7
West Bengal,Balurghat,MANAS CHAKRABORTY (GANESH),Communist Party of India (Marxist),1457,9,1466,8
West Bengal,Balurghat,RANENDRANATH MALI,Bahujan Mukti Party,1686,1,1687,9
West Bengal,Balurghat,SASTI CHANDRA SARKAR,Rashtriya Janadhikar Suraksha Party,3965,4,3969,10
West Bengal,Balurghat,SOM HEMRAM,JDP,4774,0,4774,11
West Bengal,Balurghat,SIBEN SARKAR,Independent,5647,0,5647,12
West Bengal,Balurghat,None of the Above,NOTA,11681,10,11691,13
West Bengal,Maldaha Uttar,KHAGEN MURMU,Communist Party of India  (Marxist),322265,639,322904,1
West Bengal,Maldaha Uttar,CHITTA RANJAN KIRTTANIA,Bahujan Samaj Party,6223,6,6229,2
West Bengal,Maldaha Uttar,MAUSAM NOOR,Indian National Congress,388241,368,388609,3
West Bengal,Maldaha Uttar,SUBHASH KRISHNA GOSWAMI,Bharatiya Janata Party,178639,361,179000,4
West Bengal,Maldaha Uttar,SOUMITRA RAY,All India Trinamool Congress,196886,427,197313,5
West Bengal,Maldaha Uttar,ABDUL KHALEQUE,AIUDF,4647,3,4650,6
West Bengal,Maldaha Uttar,IMANUYEL HEMRAM (BAIDYA),JDP,6803,2,6805,7
West Bengal,Maldaha Uttar,GAUTAM SARKAR,SOCIALIST UNITY CENTRE OF INDIA (COMMUNIST),8988,0,8988,8
West Bengal,Maldaha Uttar,NURUL ISLAM MAJIDI,Welfare Party of India,7118,10,7128,9
West Bengal,Maldaha Uttar,BISHNUPADA BARMAN,Amra Bangalee,4225,0,4225,10
West Bengal,Maldaha Uttar,MINARA KHATUN,HKRD,3348,0,3348,11
West Bengal,Maldaha Uttar,MILAN DAS,Samajwadi Party,12160,3,12163,12
West Bengal,Maldaha Uttar,MONATAN HEMBRAM,Bahujan Mukti Party,4693,3,4696,13
West Bengal,Maldaha Uttar,SUREN MURMU,Independent,6446,0,6446,14
West Bengal,Maldaha Uttar,None of the Above,NOTA,10470,11,10481,15
West Bengal,Maldaha Dakshin,ABU HASEM KHAN CHOWDHURY,Indian National Congress,379646,645,380291,1
West Bengal,Maldaha Dakshin,ABUL HASNAT KHAN,Communist Party of India  (Marxist),208396,1084,209480,2
West Bengal,Maldaha Dakshin,NIKHIL CHANDRA MANDAL,Bahujan Samaj Party,6133,5,6138,3
West Bengal,Maldaha Dakshin,BISNU PADA ROY,Bharatiya Janata Party,215516,664,216180,4
West Bengal,Maldaha Dakshin,MD MOAZZEM HOSSAIN,All India Trinamool Congress,192064,568,192632,5
West Bengal,Maldaha Dakshin,IMTIAZ AHMED MOLLAH,Social Democratic Party of India,12942,10,12952,6
West Bengal,Maldaha Dakshin,DIPAK SINGH,Rashtriya Janadhikar Suraksha Party,1448,1,1449,7
West Bengal,Maldaha Dakshin,NASMUL HOQUE,PDS,2466,0,2466,8
West Bengal,Maldaha Dakshin,FIROZ AKHTAR,Bahujan Mukti Party,1342,0,1342,9
West Bengal,Maldaha Dakshin,BIMAL MARDI,JDP,1920,1,1921,10
West Bengal,Maldaha Dakshin,MURSED SEKH,Republican Party of India (A),2719,1,2720,11
West Bengal,Maldaha Dakshin,MD EZARUDDIN,JeSM,3375,2,3377,12
West Bengal,Maldaha Dakshin,MD NAJRUL ISLAM,AIUDF,21198,9,21207,13
West Bengal,Maldaha Dakshin,MD FARUQUE HOSSAIN (SAHITYARATNA),Indian Union Muslim League,3279,3,3282,14
West Bengal,Maldaha Dakshin,NARESH RISHI,Independent,6616,0,6616,15
West Bengal,Maldaha Dakshin,MANJUR ALAHI MUNSHI,Independent,11426,0,11426,16
West Bengal,Maldaha Dakshin,SADHAN CHATTERJEE,Independent,10536,0,10536,17
West Bengal,Maldaha Dakshin,None of the Above,NOTA,8358,34,8392,18
West Bengal,Jangipur,ABHIJIT MUKHERJEE,Indian National Congress,378032,169,378201,1
West Bengal,Jangipur,MUZAFFAR HOSSAIN,Communist Party of India  (Marxist),369717,323,370040,2
West Bengal,Jangipur,SANJIT SINGH,Bahujan Samaj Party,5506,1,5507,3
West Bengal,Jangipur,SAMRAT GHOSH,Bharatiya Janata Party,96657,94,96751,4
West Bengal,Jangipur,SK NURUL ISLAM,All India Trinamool Congress,207331,124,207455,5
West Bengal,Jangipur,ABDUS SAYEED,SOCIALIST UNITY CENTRE OF INDIA (COMMUNIST),7924,2,7926,6
West Bengal,Jangipur,DHANANJAY BANERJEE,Amra Bangalee,3019,0,3019,7
West Bengal,Jangipur,MONIRUL ISLAM,Welfare Party of India,9475,1,9476,8
West Bengal,Jangipur,MD. GINNATULLA SK,JeSM,2318,0,2318,9
West Bengal,Jangipur,MD. SAHABUDDIN,Social Democratic Party of India,17254,3,17257,10
West Bengal,Jangipur,ABHIJIT SARKAR,Independent,10055,0,10055,11
West Bengal,Jangipur,None of the Above,NOTA,11070,9,11079,12
West Bengal,Baharampur,ADHIR RANJAN CHOWDHURY,Indian National Congress,583193,356,583549,1
West Bengal,Baharampur,INDRANIL SEN,All India Trinamool Congress,226916,66,226982,2
West Bengal,Baharampur,KUSHADHWAJ BALA,Bahujan Samaj Party,4676,0,4676,3
West Bengal,Baharampur,DEBES ADHIKARI,Bharatiya Janata Party,81610,46,81656,4
West Bengal,Baharampur,PRAMOTHES MUKHERJEE,Revolutionary Socialist Party,225652,47,225699,5
West Bengal,Baharampur,ABDUS SUKUR,Indian Union Muslim League,4321,1,4322,6
West Bengal,Baharampur,BADRUL SEKH,Social Democratic Party of India,11642,0,11642,7
West Bengal,Baharampur,MD. EZARUDDIN,JeSM,4869,0,4869,8
West Bengal,Baharampur,None of the Above,NOTA,11191,1,11192,9
West Bengal,Murshidabad,ALI MOHAMMAD,All India Trinamool Congress,288961,66,289027,1
West Bengal,Murshidabad,ABDUL MANNAN HOSSAIN,Indian National Congress,408424,70,408494,2
West Bengal,Murshidabad,JITENDRA NATH HALDER,Bahujan Samaj Party,5722,0,5722,3
West Bengal,Murshidabad,BADARUDDOZA KHAN,Communist Party of India  (Marxist),426858,89,426947,4
West Bengal,Murshidabad,SUJIT KUMAR GHOSH,Bharatiya Janata Party,101030,39,101069,5
West Bengal,Murshidabad,ABDUL BARI,Indian Union Muslim League,5383,0,5383,6
West Bengal,Murshidabad,KAMARUJJAMAN KHANDEKAR(BAKUL),SOCIALIST UNITY CENTRE OF INDIA (COMMUNIST),8378,0,8378,7
West Bengal,Murshidabad,MASUDUL ISLAM,Social Democratic Party of India,6009,1,6010,8
West Bengal,Murshidabad,MD. KHODABOX SEKH,Welfare Party of India,6445,0,6445,9
West Bengal,Murshidabad,MD. NAJMUL HOQUE,AIUDF,11333,0,11333,10
West Bengal,Murshidabad,SWAPAN KUMAR MANDAL,Amra Bangalee,4259,1,4260,11
West Bengal,Murshidabad,ASIM KUMAR DAS,Independent,4538,1,4539,12
West Bengal,Murshidabad,None of the Above,NOTA,10155,1,10156,13
West Bengal,Krishnanagar,AHMED RAZIA,Indian National Congress,74757,32,74789,1
West Bengal,Krishnanagar,JHA SHANTANU,Communist Party of India  (Marxist),366897,637,367534,2
West Bengal,Krishnanagar,TAPAS PAUL,All India Trinamool Congress,438140,649,438789,3
West Bengal,Krishnanagar,SATYA BRATA MOOKHERJEE,Bharatiya Janata Party,328873,514,329387,4
West Bengal,Krishnanagar,HARASHIT BISWAS,Bahujan Samaj Party,6165,3,6168,5
West Bengal,Krishnanagar,AHAMED HOSSAIN,Indian Union Muslim League,3746,3,3749,6
West Bengal,Krishnanagar,KAMAL DATTA,SOCIALIST UNITY CENTRE OF INDIA (COMMUNIST),7211,3,7214,7
West Bengal,Krishnanagar,MOLLA JAFORULLA,Bahujan Mukti Party,4864,1,4865,8
West Bengal,Krishnanagar,SUBIMAL SENGUPTA,Communist Party of India (Marxist-Lenninist) (Liberation),7776,1,7777,9
West Bengal,Krishnanagar,None of the Above,NOTA,7639,3,7642,10
West Bengal,Ranaghat,ARCHANA BISWAS,Communist Party of India  (Marxist),387209,1475,388684,1
West Bengal,Ranaghat,UTPALA BISWAS,Bahujan Samaj Party,9107,9,9116,2
West Bengal,Ranaghat,TAPAS MANDAL,All India Trinamool Congress,588545,1906,590451,3
West Bengal,Ranaghat,PRATAP KANTI RAY,Indian National Congress,92081,137,92218,4
West Bengal,Ranaghat,SUPRAVAT BISWAS,Bharatiya Janata Party,233239,431,233670,5
West Bengal,Ranaghat,CHAITANYA BARAI,Netaji Subhas Biplabi Parishad,3825,4,3829,6
West Bengal,Ranaghat,NADIYAR CHAND MONDAL,Republican Party of India (A),3992,0,3992,7
West Bengal,Ranaghat,PARESH HALDER,SOCIALIST UNITY CENTRE OF INDIA (COMMUNIST),7949,3,7952,8
West Bengal,Ranaghat,SUBHAS CHANDRA SARKAR,Independent,8656,2,8658,9
West Bengal,Ranaghat,None of the Above,NOTA,14587,39,14626,10
West Bengal,Bangaon,ILA MONDAL,Indian National Congress,43799,67,43866,1
West Bengal,Bangaon,KAPIL KRISHNA THAKUR,All India Trinamool Congress,550003,1210,551213,2
West Bengal,Bangaon,CHANDAN MALLICK,Bahujan Samaj Party,9187,20,9207,3
West Bengal,Bangaon,DEBESH DAS,Communist Party of India  (Marxist),403255,1357,404612,4
West Bengal,Bangaon,K.D. BISWAS,Bharatiya Janata Party,244331,452,244783,5
West Bengal,Bangaon,TARAPADA BISWAS,Amra Bangalee,2848,0,2848,6
West Bengal,Bangaon,PINAKI RANJAN BHARATI,The Religion of Man Revolving Political Party of India,1071,0,1071,7
West Bengal,Bangaon,SARAT CHANDRA MANDAL,RAHM,1171,1,1172,8
West Bengal,Bangaon,SHYAM PRASAD MONDAL,PDS,2624,0,2624,9
West Bengal,Bangaon,SWAPAN MONDAL,SOCIALIST UNITY CENTRE OF INDIA (COMMUNIST),3583,6,3589,10
West Bengal,Bangaon,PRANITA MANDAL,Independent,8738,0,8738,11
West Bengal,Bangaon,None of the Above,NOTA,9918,47,9965,12
West Bengal,Barrackpore,TAPAS SARKAR,Bahujan Samaj Party,5446,12,5458,1
West Bengal,Barrackpore,DINESH TRIVEDI,All India Trinamool Congress,478253,953,479206,2
West Bengal,Barrackpore,RUMESH KUMAR HANDA,Bharatiya Janata Party,229973,428,230401,3
West Bengal,Barrackpore,SAMRAT TOPADAR,Indian National Congress,30421,70,30491,4
West Bengal,Barrackpore,SUBHASHINI ALI,Communist Party of India  (Marxist),270951,1482,272433,5
West Bengal,Barrackpore,OMPRAKASH RAJBHAR,Communist Party of India (Marxist-Lenninist) (Liberation),4415,1,4416,6
West Bengal,Barrackpore,PRADIP CHAUDHURI,SOCIALIST UNITY CENTRE OF INDIA (COMMUNIST),2196,4,2200,7
West Bengal,Barrackpore,MIHIR BISWAS,Aam Aadmi Party,1776,11,1787,8
West Bengal,Barrackpore,SHARMISTHA CHOUDHURY,Communist Party of India (Marxist),2036,0,2036,9
West Bengal,Barrackpore,OM PRAKASH SHAW,Independent,3552,3,3555,10
West Bengal,Barrackpore,GIRISH CHANDRA SINGH,Independent,3130,2,3132,11
West Bengal,Barrackpore,DINA SHANKAR SINGH,Independent,5033,3,5036,12
West Bengal,Barrackpore,None of the Above,NOTA,10942,37,10979,13
West Bengal,Dum dum,ASIM KUMAR DASGUPTA,Communist Party of India  (Marxist),326641,1669,328310,1
West Bengal,Dum dum,TAPAN SIKDAR,Bharatiya Janata Party,254355,464,254819,2
West Bengal,Dum dum,DHANANJAY (SHAKTI) MOITRA,Indian National Congress,34062,54,34116,3
West Bengal,Dum dum,NARENDRA NATH GHOSH (NAREN GHOSH),Bahujan Samaj Party,4067,10,4077,4
West Bengal,Dum dum,SAUGATA ROY,All India Trinamool Congress,482278,966,483244,5
West Bengal,Dum dum,ASHOK KUNDU,PDS,4817,6,4823,6
West Bengal,Dum dum,SIKHA SEN ROY,Communist Party of India (Marxist),1542,2,1544,7
West Bengal,Dum dum,SATYABRATA BANDYOPADHYAY,Rashtriya Janadhikar Suraksha Party,1617,1,1618,8
West Bengal,Dum dum,SUKHA RANJAN BANIK,Independent,3256,0,3256,9
West Bengal,Dum dum,None of the Above,NOTA,16769,68,16837,10
West Bengal,Barasat,RIJU GHOSAL,Indian National Congress,40586,74,40660,1
West Bengal,Barasat,DR. KAKALI GHOSHDOSTIDAR,All India Trinamool Congress,524105,1282,525387,2
West Bengal,Barasat,DR. MORTOZA HOSSAIN,All India Forward Bloc,350763,1483,352246,3
West Bengal,Barasat,P.C. SORCAR JUNIOR,Bharatiya Janata Party,295982,626,296608,4
West Bengal,Barasat,SUKUMAR BALA,Bahujan Samaj Party,12156,22,12178,5
West Bengal,Barasat,PARESH CHANDRA GHOSH,SOCIALIST UNITY CENTRE OF INDIA (COMMUNIST),2434,5,2439,6
West Bengal,Barasat,BIKASH HAZRA,Bahujan Mukti Party,1476,2,1478,7
West Bengal,Barasat,MD. RAFIKUL ISLAM,Welfare Party of India,6885,10,6895,8
West Bengal,Barasat,SUKLA BHUIMALI,Communist Party of India (Marxist),1329,3,1332,9
West Bengal,Barasat,KALYAN BASAK,Independent,4119,3,4122,10
West Bengal,Barasat,SHRI KAUSHIK DAS GUPTA,Independent,6374,1,6375,11
West Bengal,Barasat,MORTTAJA HOSEN,Independent,6886,25,6911,12
West Bengal,Barasat,None of the Above,NOTA,12651,49,12700,13
West Bengal,Basirhat,ABDUR RAHIM QUAZI,Indian National Congress,102087,43,102130,1
West Bengal,Basirhat,IDRIS ALI,All India Trinamool Congress,492054,272,492326,2
West Bengal,Basirhat,GOPAL DAS,Bahujan Samaj Party,7016,0,7016,3
West Bengal,Basirhat,NURUL HUDA,Communist Party of India,382320,347,382667,4
West Bengal,Basirhat,SAMIK BHATTACHARYA,Bharatiya Janata Party,233690,197,233887,5
West Bengal,Basirhat,AJAY KUMAR BAIN,SOCIALIST UNITY CENTRE OF INDIA (COMMUNIST),6531,1,6532,6
West Bengal,Basirhat,CHOWDHURY SIDDIQULLAH,AIUDF,25172,6,25178,7
West Bengal,Basirhat,MD. HAFIZ,Independent,5976,0,5976,8
West Bengal,Basirhat,RANJIT GAYEN,Independent,8088,0,8088,9
West Bengal,Basirhat,None of the Above,NOTA,9963,8,9971,10
West Bengal,Joynagar,ARNAB ROY,Indian National Congress,38480,13,38493,1
West Bengal,Joynagar,ANANYA SARKAR,Bahujan Samaj Party,2907,2,2909,2
West Bengal,Joynagar,KRISHNAPADA MAJUMDER,Bharatiya Janata Party,113149,57,113206,3
West Bengal,Joynagar,PRATIMA MONDAL,All India Trinamool Congress,494580,166,494746,4
West Bengal,Joynagar,SUBHAS NASKAR,Revolutionary Socialist Party,386161,201,386362,5
West Bengal,Joynagar,TARANGA MONDAL,AIUDF,13331,2,13333,6
West Bengal,Joynagar,DR. TARUN MANDAL,SOCIALIST UNITY CENTRE OF INDIA (COMMUNIST),117412,42,117454,7
West Bengal,Joynagar,MANIKLAL SARDAR,Rashtriya Janadhikar Suraksha Party,5908,0,5908,8
West Bengal,Joynagar,DR. RABIN NASKAR,Bahujan Mukti Party,2652,5,2657,9
West Bengal,Joynagar,SUBHAS NASKAR,Independent,5153,8,5161,10
West Bengal,Joynagar,None of the Above,NOTA,8812,7,8819,11
West Bengal,Mathurapur,CHOUDHURY MOHAN JATUA,All India Trinamool Congress,629612,650,630262,1
West Bengal,Mathurapur,TAPAN NASKAR,Bharatiya Janata Party,66478,60,66538,2
West Bengal,Mathurapur,SHRI MANORANJAN HALDER,Indian National Congress,47353,23,47376,3
West Bengal,Mathurapur,RINKU NASKAR,Communist Party of India  (Marxist),490977,517,491494,4
West Bengal,Mathurapur,SOUMEN SARADAR,Bahujan Samaj Party,4395,0,4395,5
West Bengal,Mathurapur,NANDADULAL MANDAL,Rashtriya Janasachetan Party (R.J.P.),1361,0,1361,6
West Bengal,Mathurapur,PURNA CHANDRA NAIYA,SOCIALIST UNITY CENTRE OF INDIA (COMMUNIST),10195,8,10203,7
West Bengal,Mathurapur,MANTU RAM HALDER,Welfare Party of India,4689,4,4693,8
West Bengal,Mathurapur,RABINDRANATH MISTRI,PDS,3221,0,3221,9
West Bengal,Mathurapur,ABANINDRA NATH BAIDYA,Independent,2099,1,2100,10
West Bengal,Mathurapur,None of the Above,NOTA,9336,6,9342,11
West Bengal,Diamond harbour,ABHIJIT DAS (BOBBY),Bharatiya Janata Party,200686,172,200858,1
West Bengal,Diamond harbour,ABHISHEK BANERJEE,All India Trinamool Congress,508130,351,508481,2
West Bengal,Diamond harbour,DR. ABUL HASNAT,Communist Party of India  (Marxist),436713,470,437183,3
West Bengal,Diamond harbour,MD. QAMRUZZAMAN QAMAR,Indian National Congress,63027,20,63047,4
West Bengal,Diamond harbour,DILIP KUMAR MANDAL,Bahujan Samaj Party,2890,2,2892,5
West Bengal,Diamond harbour,AJAY GHOSH,SOCIALIST UNITY CENTRE OF INDIA (COMMUNIST),2529,0,2529,6
West Bengal,Diamond harbour,JAYNAL ABEDIN MONDAL,Indian Union Muslim League,1855,1,1856,7
West Bengal,Diamond harbour,NAZMA YASMEEN,Welfare Party of India,3271,1,3272,8
West Bengal,Diamond harbour,SAMIR PUTATUNDA,PDS,1320,2,1322,9
West Bengal,Diamond harbour,HABIBUR RAHAMAN MOLLA,Rashtriya Janasachetan Party (R.J.P.),1258,2,1260,10
West Bengal,Diamond harbour,ALOK SEN,Independent,976,1,977,11
West Bengal,Diamond harbour,BIJAN MAJUMDER,Independent,1346,2,1348,12
West Bengal,Diamond harbour,BECHU MONDAL,Independent,3606,1,3607,13
West Bengal,Diamond harbour,SAILEN SADHUKHAN,Independent,6632,1,6633,14
West Bengal,Diamond harbour,SUDIP KUMAR SAHA,Independent,8740,0,8740,15
West Bengal,Diamond harbour,SOUGATA GHOSH,Independent,6634,0,6634,16
West Bengal,Diamond harbour,None of the Above,NOTA,10639,18,10657,17
West Bengal,Jadavpur,SANDHYA MANDAL,Bahujan Samaj Party,3938,7,3945,1
West Bengal,Jadavpur,SAMIR AICH,Indian National Congress,26307,37,26344,2
West Bengal,Jadavpur,DR. SARUP PRASAD GHOSH,Bharatiya Janata Party,155338,173,155511,3
West Bengal,Jadavpur,SUGATA BOSE,All India Trinamool Congress,583490,754,584244,4
West Bengal,Jadavpur,SUJAN CHAKRABORTY,Communist Party of India  (Marxist),458050,991,459041,5
West Bengal,Jadavpur,DR. ASOK KUMAR SAMANTA,SOCIALIST UNITY CENTRE OF INDIA (COMMUNIST),11307,10,11317,6
West Bengal,Jadavpur,PINTU SANPUI,Bahujan Mukti Party,1335,5,1340,7
West Bengal,Jadavpur,HASIBUL ISLAM MIR,Rashtriya Janasachetan Party (R.J.P.),1464,0,1464,8
West Bengal,Jadavpur,ASHOK KUMAR SHAW,Independent,1294,0,1294,9
West Bengal,Jadavpur,KARTIK KAYAL,Independent,2837,0,2837,10
West Bengal,Jadavpur,MANGAL KUMAR SARDAR,Independent,3405,1,3406,11
West Bengal,Jadavpur,SHAMALI DAS,Independent,2884,1,2885,12
West Bengal,Jadavpur,SUSANTA KUMAR NASKAR,Independent,3066,1,3067,13
West Bengal,Jadavpur,None of the Above,NOTA,15633,34,15667,14
West Bengal,Kolkata Dakshin,MALA ROY,Indian National Congress,113377,76,113453,1
West Bengal,Kolkata Dakshin,NANDINI MUKHERJEE,Communist Party of India  (Marxist),277706,708,278414,2
West Bengal,Kolkata Dakshin,OMPRAKASH PRAJAPATI,Bahujan Samaj Party,4559,5,4564,3
West Bengal,Kolkata Dakshin,SUBRATA BAKSHI,All India Trinamool Congress,431119,596,431715,4
West Bengal,Kolkata Dakshin,TATHAGATA ROY,Bharatiya Janata Party,295126,250,295376,5
West Bengal,Kolkata Dakshin,HITANGSHU BANERJEE,Amra Bangalee,2918,3,2921,6
West Bengal,Kolkata Dakshin,KARAN SINGH,IJP,1103,0,1103,7
West Bengal,Kolkata Dakshin,MD. HESHAMUDDIN,Welfare Party of India,1553,1,1554,8
West Bengal,Kolkata Dakshin,K. P. MD. SHARIF,Indian Union Muslim League,3770,6,3776,9
West Bengal,Kolkata Dakshin,RAVEENDRAN. T.P (RAVI PALOOR),Communist Party of India (Marxist),874,1,875,10
West Bengal,Kolkata Dakshin,SYED MD WASIM RAZA,All India Minorities Front,1193,2,1195,11
West Bengal,Kolkata Dakshin,ZUBAIR RABBANI,SOCIALIST UNITY CENTRE OF INDIA (COMMUNIST),3988,6,3994,12
West Bengal,Kolkata Dakshin,ASHOKE BISWAS,Independent,4334,1,4335,13
West Bengal,Kolkata Dakshin,BADRI MONDAL,Independent,1844,0,1844,14
West Bengal,Kolkata Dakshin,SHAMALI DAS,Independent,3356,0,3356,15
West Bengal,Kolkata Dakshin,None of the Above,NOTA,19472,39,19511,16
West Bengal,Kolkata Uttar,BAGCHI RUPA,Communist Party of India  (Marxist),195591,462,196053,1
West Bengal,Kolkata Uttar,PHUL CHAND RAM,Bahujan Samaj Party,2125,2,2127,2
West Bengal,Kolkata Uttar,RAHUL (BISWAJIT) SINHA,Bharatiya Janata Party,247316,145,247461,3
West Bengal,Kolkata Uttar,SOMENDRANATH MITRA,Indian National Congress,130714,69,130783,4
West Bengal,Kolkata Uttar,SUDIP BANDYOPADHYAY,All India Trinamool Congress,343389,298,343687,5
West Bengal,Kolkata Uttar,ALOK CHATURVEDI,Aam Aadmi Party,4397,2,4399,6
West Bengal,Kolkata Uttar,S.M. HABIBULLAH,GaAP,660,0,660,7
West Bengal,Kolkata Uttar,MD. IBRAHIM KHAN,Indian Union Muslim League,749,0,749,8
West Bengal,Kolkata Uttar,MITUL KUMAR SINGH,RAHM,548,0,548,9
West Bengal,Kolkata Uttar,TARUN MUKHERJEE,Rashtriya Janasachetan Party (R.J.P.),708,0,708,10
West Bengal,Kolkata Uttar,DEBAJYOTI SENGUPTA,Independent,1435,0,1435,11
West Bengal,Kolkata Uttar,DR. DEVENDRA PANDEY,Independent,4168,0,4168,12
West Bengal,Kolkata Uttar,KALI PADA JANA,Independent,1860,0,1860,13
West Bengal,Kolkata Uttar,KAUSHIK BISWAS,Independent,1810,0,1810,14
West Bengal,Kolkata Uttar,RATHINDRA NATH ROY,Independent,1149,0,1149,15
West Bengal,Kolkata Uttar,SANJOY SAHA,Independent,4808,0,4808,16
West Bengal,Kolkata Uttar,SAUMEN MITRA,Independent,3752,0,3752,17
West Bengal,Kolkata Uttar,SUNIRMAL BASU,Independent,518,0,518,18
West Bengal,Kolkata Uttar,None of the Above,NOTA,9086,17,9103,19
West Bengal,Howrah,GEORGE BAKER,Bharatiya Janata Party,248055,65,248120,1
West Bengal,Howrah,PRASUN BANERJEE,All India Trinamool Congress,488339,122,488461,2
West Bengal,Howrah,MANOJ KUMAR PANDEY,Indian National Congress,63245,9,63254,3
West Bengal,Howrah,SHIB CHANDRA RAM,Bahujan Samaj Party,3241,0,3241,4
West Bengal,Howrah,SRIDIP BHATTACHARYA,Communist Party of India  (Marxist),291345,160,291505,5
West Bengal,Howrah,GOBARDDHAN MANNA,IUC,2680,0,2680,6
West Bengal,Howrah,MOHAMMAD SIRAJUDDIN SEKH,GaAP,1079,0,1079,7
West Bengal,Howrah,SUKUMAR BARAL,Bahujan Mukti Party,635,0,635,8
West Bengal,Howrah,SURAJ NARAYAN SINGH,Aam Aadmi Party,2184,2,2186,9
West Bengal,Howrah,SOUMITRA SENGUPTA,SOCIALIST UNITY CENTRE OF INDIA (COMMUNIST),1813,1,1814,10
West Bengal,Howrah,DINESH KUMAR SHARMA,Independent,2343,0,2343,11
West Bengal,Howrah,MRITYUNJAY SARKAR,Independent,2034,0,2034,12
West Bengal,Howrah,SAJAL KUMAR DAS,Independent,1572,0,1572,13
West Bengal,Howrah,SANJIB SARKAR,Independent,2105,0,2105,14
West Bengal,Howrah,SONIA DAS,Independent,4441,0,4441,15
West Bengal,Howrah,None of the Above,NOTA,9924,5,9929,16
West Bengal,Uluberia,ASIT MITRA,Indian National Congress,67815,11,67826,1
West Bengal,Uluberia,RANJIT KISHORE MOHANTY,Bharatiya Janata Party,137069,68,137137,2
West Bengal,Uluberia,REKHA DAS,Bahujan Samaj Party,3918,0,3918,3
West Bengal,Uluberia,SABIR UDDIN MOLLA,Communist Party of India  (Marxist),369393,170,369563,4
West Bengal,Uluberia,SULTAN AHMED,All India Trinamool Congress,570598,187,570785,5
West Bengal,Uluberia,ABUL QASEM,IUC,6607,0,6607,6
West Bengal,Uluberia,MINATI SARKAR,SOCIALIST UNITY CENTRE OF INDIA (COMMUNIST),2899,3,2902,7
West Bengal,Uluberia,SUJATA DUTTA,Bahujan Mukti Party,1400,0,1400,8
West Bengal,Uluberia,HASAN NAWAJ,AIUDF,5708,1,5709,9
West Bengal,Uluberia,ASHIS KUMAR DAS,Independent,2437,0,2437,10
West Bengal,Uluberia,DILIP KUMAR HAIT,Independent,3947,0,3947,11
West Bengal,Uluberia,RAMESH DHARA,Independent,2529,0,2529,12
West Bengal,Uluberia,SUSANTA KUMAR DALUI,Independent,2990,0,2990,13
West Bengal,Uluberia,None of the Above,NOTA,8274,3,8277,14
West Bengal,Srerampur,ABDUL MANNAN,Indian National Congress,86043,56,86099,1
West Bengal,Srerampur,KALYAN BANERJEE,All India Trinamool Congress,514484,449,514933,2
West Bengal,Srerampur,TIRTHANKAR RAY,Communist Party of India  (Marxist),361744,663,362407,3
West Bengal,Srerampur,BAPPI LAHIRI,Bharatiya Janata Party,287456,256,287712,4
West Bengal,Srerampur,NASIRUDDIN MIR,IUC,4240,0,4240,5
West Bengal,Srerampur,MANASA SEN,Welfare Party of India,3406,0,3406,6
West Bengal,Srerampur,MD. SHANAWAZ,SOCIALIST UNITY CENTRE OF INDIA (COMMUNIST),2697,1,2698,7
West Bengal,Srerampur,KAILASH NASKAR,Independent,2673,1,2674,8
West Bengal,Srerampur,RAJU DEY SARKAR,Independent,4277,0,4277,9
West Bengal,Srerampur,DR. SOMNATH GHOSH,Independent,6613,0,6613,10
West Bengal,Srerampur,None of the Above,NOTA,15350,24,15374,11
West Bengal,Hooghly,DR. CHANDAN MITRA,Bharatiya Janata Party,220898,373,221271,1
West Bengal,Hooghly,PRADIP SAHA,Communist Party of India  (Marxist),424060,1168,425228,2
West Bengal,Hooghly,PRITAM GHOSH,Indian National Congress,42173,53,42226,3
West Bengal,Hooghly,VIJAY KUMAR MAHATO,Bahujan Samaj Party,5515,4,5519,4
West Bengal,Hooghly,DR. RATNA DE (NAG),All India Trinamool Congress,613118,1194,614312,5
West Bengal,Hooghly,PABAN MAZUMDER,SOCIALIST UNITY CENTRE OF INDIA (COMMUNIST),7676,6,7682,6
West Bengal,Hooghly,SHUKCHAND MURMU,JDP,3196,1,3197,7
West Bengal,Hooghly,SANGHAMITRA MUKHERJEE,Rashtriya Janasachetan Party (R.J.P.),3766,0,3766,8
West Bengal,Hooghly,SAJAL ADHIKARI,Communist Party of India (Marxist-Lenninist) (Liberation),9146,6,9152,9
West Bengal,Hooghly,None of the Above,NOTA,16469,48,16517,10
West Bengal,Arambagh,APARUPA PODDAR (AFRIN ALI),All India Trinamool Congress,748168,596,748764,1
West Bengal,Arambagh,MADHUSUDAN BAG,Bharatiya Janata Party,158311,169,158480,2
West Bengal,Arambagh,SAKTIMOHAN MALIK,Communist Party of India  (Marxist),401291,628,401919,3
West Bengal,Arambagh,SAMBHUNATH MALIK,Indian National Congress,27850,22,27872,4
West Bengal,Arambagh,GANESH BAG,JDP,7061,1,7062,5
West Bengal,Arambagh,None of the Above,NOTA,17816,21,17837,6
West Bengal,Tamluk,ADHIKARI SUVENDU,All India Trinamool Congress,715556,1372,716928,1
West Bengal,Tamluk,ANWAR ALI SK,Indian National Congress,29613,32,29645,2
West Bengal,Tamluk,KAMAL BAG,Bahujan Samaj Party,3109,1,3110,3
West Bengal,Tamluk,BADSHA ALAM,Bharatiya Janata Party,86138,127,86265,4
West Bengal,Tamluk,SEKH IBRAHIM ALI,Communist Party of India  (Marxist),469425,1022,470447,5
West Bengal,Tamluk,BIBEKANANDA RAY,SOCIALIST UNITY CENTRE OF INDIA (COMMUNIST),10176,21,10197,6
West Bengal,Tamluk,MANIK CHANDRA MONDAL,Indian Union Muslim League,1499,1,1500,7
West Bengal,Tamluk,ABDUR REZAK SK,Independent,1681,1,1682,8
West Bengal,Tamluk,KALISANKAR JANA,Independent,2656,2,2658,9
West Bengal,Tamluk,RAJYASHREE CHAUDHURI,Independent,3604,5,3609,10
West Bengal,Tamluk,None of the Above,NOTA,11601,42,11643,11
West Bengal,Kanthi,ADHIKARI SISIR KUMAR,All India Trinamool Congress,675899,850,676749,1
West Bengal,Kanthi,ANSAR ALI SK,Bahujan Samaj Party,8296,2,8298,2
West Bengal,Kanthi,KAMALENDU PAHARI,Bharatiya Janata Party,110956,126,111082,3
West Bengal,Kanthi,KUNAL BANERJEE,Indian National Congress,27210,20,27230,4
West Bengal,Kanthi,SINHA TAPAS,Communist Party of India  (Marxist),446568,691,447259,5
West Bengal,Kanthi,MANAS PRADHAN,SOCIALIST UNITY CENTRE OF INDIA (COMMUNIST),7318,17,7335,6
West Bengal,Kanthi,SK GOLAM NABI AJAD,Independent,3260,0,3260,7
West Bengal,Kanthi,None of the Above,NOTA,9571,27,9598,8
West Bengal,Ghatal,ADHIKARI DEEPAK (DEV),All India Trinamool Congress,685122,574,685696,1
West Bengal,Ghatal,MD. ALAM,Bharatiya Janata Party,94725,117,94842,2
West Bengal,Ghatal,MANAS RANJAN BHUNIA,Indian National Congress,123018,110,123128,3
West Bengal,Ghatal,SANTOSH RANA,Communist Party of India,424183,622,424805,4
West Bengal,Ghatal,ANJAN JANA,SOCIALIST UNITY CENTRE OF INDIA (COMMUNIST),8073,7,8080,5
West Bengal,Ghatal,GANGARAM SASMAL,PDS,1758,0,1758,6
West Bengal,Ghatal,GOPAL MURMU,JHAP,2154,0,2154,7
West Bengal,Ghatal,GOBARDHAN GHOSH,Rashtriya Janadhikar Suraksha Party,1982,1,1983,8
West Bengal,Ghatal,GOUTAM KOURI,Amra Bangalee,5546,1,5547,9
West Bengal,Ghatal,GOPAL MONDAL,Independent,4498,0,4498,10
West Bengal,Ghatal,None of the Above,NOTA,14406,12,14418,11
West Bengal,Jhargram,ANITA HANSDA,Indian National Congress,40489,24,40513,1
West Bengal,Jhargram,UMA SAREN,All India Trinamool Congress,673798,706,674504,2
West Bengal,Jhargram,DR. PULIN BIHARI BASKE,Communist Party of India  (Marxist),326236,385,326621,3
West Bengal,Jhargram,BIKASH MUDI,Bharatiya Janata Party,122321,138,122459,4
West Bengal,Jhargram,GOMASTA PRASAD SOREN,AKBJHP,8363,1,8364,5
West Bengal,Jhargram,CHUNIBALA HANSDA,Jharkhand Party (Naren),7604,4,7608,6
West Bengal,Jhargram,BUDDHADEB MANDI,Jharkhand Mukti Morcha,15111,3,15114,7
West Bengal,Jhargram,MILAN MANDI,JDP,6011,2,6013,8
West Bengal,Jhargram,MURARI MOHAN BASKE,JHAP,3877,0,3877,9
West Bengal,Jhargram,RAJIB MUDI,SOCIALIST UNITY CENTRE OF INDIA (COMMUNIST),5057,1,5058,10
West Bengal,Jhargram,RAMPADA HANSDA,Amra Bangalee,8478,0,8478,11
West Bengal,Jhargram,SUBODH KUMAR MANDI,Independent,7453,0,7453,12
West Bengal,Jhargram,HIRANMOY MAJHI,Independent,8613,3,8616,13
West Bengal,Jhargram,None of the Above,NOTA,22925,10,22935,14
West Bengal,Medinipur,KAVITA RANI,Bahujan Samaj Party,8639,1,8640,1
West Bengal,Medinipur,PRABODH PANDA,Communist Party of India,394903,410,395313,2
West Bengal,Medinipur,PRABHAKAR TEWARI,Bharatiya Janata Party,179735,336,180071,3
West Bengal,Medinipur,DR. BIMAL KUMAR RAJ,Indian National Congress,48883,31,48914,4
West Bengal,Medinipur,SANDHYA ROY,All India Trinamool Congress,579881,560,580441,5
West Bengal,Medinipur,ASHOK BERA,Amra Bangalee,7880,1,7881,6
West Bengal,Medinipur,TUSHAR JANA,SOCIALIST UNITY CENTRE OF INDIA (COMMUNIST),9795,5,9800,7
West Bengal,Medinipur,MUKIM KHAN,Jharkhand Mukti Morcha,5338,1,5339,8
West Bengal,Medinipur,SOUMEN SAMANTA,PDS,6070,0,6070,9
West Bengal,Medinipur,RAMKRISNA SARKAR,Independent,4661,2,4663,10
West Bengal,Medinipur,None of the Above,NOTA,13595,21,13616,11
West Bengal,Purulia,NARAHARI  MAHATO,All India Forward Bloc,313169,1231,314400,1
West Bengal,Purulia,NEPAL MAHATA,Indian National Congress,257396,527,257923,2
West Bengal,Purulia,BIKASH BANERJEE,Bharatiya Janata Party,85978,258,86236,3
West Bengal,Purulia,MIHIR KUMAR RAJWAR,Bahujan Samaj Party,9847,3,9850,4
West Bengal,Purulia,DR. MRIGANKA MAHATO,All India Trinamool Congress,466980,1297,468277,5
West Bengal,Purulia,AJIT PRASAD MAHATA,JVM,9012,0,9012,6
West Bengal,Purulia,TAPAN KUMAR MAHATO,Jharkhand Mukti Morcha,7384,2,7386,7
West Bengal,Purulia,BAIDYANATH HANSDA,JDP,7161,7,7168,8
West Bengal,Purulia,SUBARNA  KUMAR,SOCIALIST UNITY CENTRE OF INDIA (COMMUNIST),11258,8,11266,9
West Bengal,Purulia,DHIREN RAJAK,Independent,5584,0,5584,10
West Bengal,Purulia,PURNA CHANDRA TUDU,Independent,4073,0,4073,11
West Bengal,Purulia,MONBODH MAHATO,Independent,6773,1,6774,12
West Bengal,Purulia,None of the Above,NOTA,16694,32,16726,13
West Bengal,Bankura,ACHARIA BASUDEB,Communist Party of India  (Marxist),384400,549,384949,1
West Bengal,Bankura,NILMADHAB GUPTA,Indian National Congress,22008,13,22021,2
West Bengal,Bankura,BINOY CHOWDHURY,Bahujan Samaj Party,7386,2,7388,3
West Bengal,Bankura,SREEMATI  DEV VARMA (MOON MOON SEN),All India Trinamool Congress,482911,544,483455,4
West Bengal,Bankura,SUBHAS KUMAR SARKAR,Bharatiya Janata Party,250853,330,251183,5
West Bengal,Bankura,KABITA SINGHABABU,SOCIALIST UNITY CENTRE OF INDIA (COMMUNIST),9123,2,9125,6
West Bengal,Bankura,PARESH MARANDI,Jharkhand Mukti Morcha,10228,1,10229,7
West Bengal,Bankura,PANMANI BESRA,JDP,5909,0,5909,8
West Bengal,Bankura,BANERJEE PRABIR,JHAP,6208,1,6209,9
West Bengal,Bankura,SHIB SANKAR GHOSH,JVM,3105,0,3105,10
West Bengal,Bankura,SUDHIR KUMAR MURMU,Communist Party of India (Marxist-Lenninist) (Liberation),7579,0,7579,11
West Bengal,Bankura,HULU KHETRAPAL,Bahujan Mukti Party,7561,3,7564,12
West Bengal,Bankura,GOUR CHANDRA HEMBRAM,Independent,4876,0,4876,13
West Bengal,Bankura,SHYAMAL SIKDAR,Independent,9045,0,9045,14
West Bengal,Bankura,None of the Above,NOTA,23662,20,23682,15
West Bengal,Bishnupur,KHAN SAUMITRA,All India Trinamool Congress,578255,615,578870,1
West Bengal,Bishnupur,JAGADANANDA ROY,Bahujan Samaj Party,10121,6,10127,2
West Bengal,Bishnupur,JAYANTA MONDAL,Bharatiya Janata Party,179247,283,179530,3
West Bengal,Bishnupur,NARAYAN CHANDRA KHAN,Indian National Congress,27031,23,27054,4
West Bengal,Bishnupur,SUSMITA BAURI,Communist Party of India  (Marxist),428791,394,429185,5
West Bengal,Bishnupur,JOYDEB BAURI,Bahujan Mukti Party,7812,4,7816,6
West Bengal,Bishnupur,SADANANDA MANDAL,SOCIALIST UNITY CENTRE OF INDIA (COMMUNIST),4886,0,4886,7
West Bengal,Bishnupur,TARANI ROY,Independent,6854,0,6854,8
West Bengal,Bishnupur,DINESH LOHAR,Independent,6819,1,6820,9
West Bengal,Bishnupur,None of the Above,NOTA,20915,13,20928,10
West Bengal,Bardhaman Purba,ISWAR CHANDRA DAS,Communist Party of India  (Marxist),459911,270,460181,1
West Bengal,Bardhaman Purba,CHANDANA MAJHI,Indian National Congress,68849,35,68884,2
West Bengal,Bardhaman Purba,MUKUL BISWAS,Bahujan Samaj Party,5436,6,5442,3
West Bengal,Bardhaman Purba,SANTOSH ROY,Bharatiya Janata Party,170722,106,170828,4
West Bengal,Bardhaman Purba,SUNIL KUMAR MONDAL,All India Trinamool Congress,574315,245,574560,5
West Bengal,Bardhaman Purba,KALICHARAN SARDAR,SOCIALIST UNITY CENTRE OF INDIA (COMMUNIST),7980,1,7981,6
West Bengal,Bardhaman Purba,PEJUSH KUMAR SAHANA,Communist Party of India (Marxist-Lenninist) (Liberation),5919,0,5919,7
West Bengal,Bardhaman Purba,PROSANTA BAG,JDP,3410,0,3410,8
West Bengal,Bardhaman Purba,SWAPAN MALIK,Jharkhand Mukti Morcha,9666,0,9666,9
West Bengal,Bardhaman Purba,None of the Above,NOTA,13944,7,13951,10
West Bengal,Burdwan - durgapur,AGASTY PRADIP,Indian National Congress,44323,32,44355,1
West Bengal,Burdwan - durgapur,DEBASREE CHAUDHURI,Bharatiya Janata Party,236944,261,237205,2
West Bengal,Burdwan - durgapur,DR. MAMTAZ SANGHAMITA,All India Trinamool Congress,553926,595,554521,3
West Bengal,Burdwan - durgapur,MD. HARUN,Bahujan Samaj Party,11857,5,11862,4
West Bengal,Burdwan - durgapur,SK. SAIDUL HAQUE,Communist Party of India  (Marxist),446662,528,447190,5
West Bengal,Burdwan - durgapur,DR. DHANAPATI DAS,Bahujan Mukti Party,6663,2,6665,6
West Bengal,Burdwan - durgapur,SUNIL KUMAR PURKAIT,SOCIALIST UNITY CENTRE OF INDIA (COMMUNIST),7573,1,7574,7
West Bengal,Burdwan - durgapur,SARADA MONI SAMANTA,Independent,4983,1,4984,8
West Bengal,Burdwan - durgapur,None of the Above,NOTA,16858,28,16886,9
West Bengal,Asansol,INDRANI MISHRA,Indian National Congress,48499,3,48502,1
West Bengal,Asansol,JARASANDHA SINHA,Bahujan Samaj Party,4663,0,4663,2
West Bengal,Asansol,DOLA SEN,All India Trinamool Congress,349435,68,349503,3
West Bengal,Asansol,BANSA GOPAL CHOUDHURY,Communist Party of India  (Marxist),255806,23,255829,4
West Bengal,Asansol,BABUL SUPRIYA BARAL (BABUL SUPRIYO),Bharatiya Janata Party,419887,96,419983,5
West Bengal,Asansol,ATUL CHANDRA  BOURI,Bahujan Mukti Party,4256,0,4256,6
West Bengal,Asansol,ANANTA LAL GUPTA,SOCIALIST UNITY CENTRE OF INDIA (COMMUNIST),3115,0,3115,7
West Bengal,Asansol,KANAI BANERJEE,Jharkhand Mukti Morcha,5728,0,5728,8
West Bengal,Asansol,BURO MURMU,JDP,2434,0,2434,9
West Bengal,Asansol,MD. MUSTAQIM,GaAP,2449,1,2450,10
West Bengal,Asansol,MD. REYAZUDDIN,Indian Union Muslim League,4947,0,4947,11
West Bengal,Asansol,JYOTIRMOY MAITI,Independent,10227,0,10227,12
West Bengal,Asansol,MANASH SARKAR,Independent,14262,1,14263,13
West Bengal,Asansol,SUJIT KAR,Independent,5016,0,5016,14
West Bengal,Asansol,None of the Above,NOTA,11475,4,11479,15
West Bengal,Bolpur,ANUPAM HAZRA,All India Trinamool Congress,630085,608,630693,1
West Bengal,Bolpur,KAMINI MOHAN SARKAR,Bharatiya Janata Party,197174,300,197474,2
West Bengal,Bolpur,DOME RAMCHANDRA,Communist Party of India  (Marxist),394246,335,394581,3
West Bengal,Bolpur,TAPAN KUMAR SAHA,Indian National Congress,46922,31,46953,4
West Bengal,Bolpur,SAMIRAN DAS,Bahujan Samaj Party,5951,1,5952,5
West Bengal,Bolpur,BIJOY DOLUI,SOCIALIST UNITY CENTRE OF INDIA (COMMUNIST),5410,0,5410,6
West Bengal,Bolpur,SANJIB MALIK,JDP,6371,0,6371,7
West Bengal,Bolpur,None of the Above,NOTA,17304,18,17322,8
West Bengal,Birbhum,DR. ELAHI KAMRE MAHAMMAD,Communist Party of India  (Marxist),393096,209,393305,1
West Bengal,Birbhum,JOY BANERJEE,Bharatiya Janata Party,235478,275,235753,2
West Bengal,Birbhum,PRABIR MUKHOPADHYAY,Bahujan Samaj Party,7140,1,7141,3
West Bengal,Birbhum,SATABDI ROY,All India Trinamool Congress,460216,352,460568,4
West Bengal,Birbhum,SYED SIRAJ JIMMI,Indian National Congress,132054,30,132084,5
West Bengal,Birbhum,AYESHA KHATUN,SOCIALIST UNITY CENTRE OF INDIA (COMMUNIST),6593,0,6593,6
West Bengal,Birbhum,NURUL ISLAM,Janata Dal (United),2203,2,2205,7
West Bengal,Birbhum,PRASANTA ROY,Samajwadi Party,7193,1,7194,8
West Bengal,Birbhum,SHIBRATAN SHARMA,Jharkhand Mukti Morcha,7989,0,7989,9
West Bengal,Birbhum,SAJAL DAS,Bahujan Mukti Party,2981,1,2982,10
West Bengal,Birbhum,SUTTAM DAS,Independent,5448,0,5448,11
West Bengal,Birbhum,None of the Above,NOTA,14545,12,14557,12
Jharkhand,Rajmahal,DR. ANIL MURMU,JVM,97370,4,97374,1
Jharkhand,Rajmahal,ARUN MARANDI,Bahujan Samaj Party,4775,0,4775,2
Jharkhand,Rajmahal,ARJUN PRASAD SINGH,AJSUP,6760,1,6761,3
Jharkhand,Rajmahal,JYOTIN SOREN,Communist Party of India  (Marxist),58034,0,58034,4
Jharkhand,Rajmahal,VIJAY KUMAR HANSDAK,Jharkhand Mukti Morcha,379337,170,379507,5
Jharkhand,Rajmahal,HEMLAL MURMU,Bharatiya Janata Party,338080,90,338170,6
Jharkhand,Rajmahal,KRISHNA SINGH,Indian Union Muslim League,16354,0,16354,7
Jharkhand,Rajmahal,BARNARD HEMBROM,Rashtriya Krantikari Samajwadi Party,8686,0,8686,8
Jharkhand,Rajmahal,TALA HANSDA,Independent,7661,0,7661,9
Jharkhand,Rajmahal,SUNIRAM HEMBROM,Independent,6460,0,6460,10
Jharkhand,Rajmahal,DR. SURAE SOREN,Independent,7906,0,7906,11
Jharkhand,Rajmahal,None of the Above,NOTA,19872,3,19875,12
Jharkhand,Dumka,CHHAYA KOLE,Communist Party of India,26439,3,26442,1
Jharkhand,Dumka,BABU LAL MARANDI,JVM,158001,121,158122,2
Jharkhand,Dumka,SHIBU SOREN,Jharkhand Mukti Morcha,335686,129,335815,3
Jharkhand,Dumka,SUNIL SOREN,Bharatiya Janata Party,296493,292,296785,4
Jharkhand,Dumka,SOKOL HANSDA,Bahujan Samaj Party,9059,0,9059,5
Jharkhand,Dumka,BABULAL SOREN,All India Trinamool Congress,6284,0,6284,6
Jharkhand,Dumka,BITIYA MANJHI,Communist Party of India (Marxist-Lenninist) (Liberation),5813,0,5813,7
Jharkhand,Dumka,SAHADEO SOREN,Aam Aadmi Party,3738,1,3739,8
Jharkhand,Dumka,STEPHAN BESRA,JDP,4310,0,4310,9
Jharkhand,Dumka,UMANATH KOLE,Independent,3733,0,3733,10
Jharkhand,Dumka,JOSHIL MURMU,Independent,4567,0,4567,11
Jharkhand,Dumka,PULIS HEMRAM,Independent,10283,0,10283,12
Jharkhand,Dumka,BAGHRAI SOREN,Independent,9436,0,9436,13
Jharkhand,Dumka,SHRILAL KISKU,Independent,10347,0,10347,14
Jharkhand,Dumka,None of the Above,NOTA,18325,0,18325,15
Jharkhand,Godda,NISHIKANT DUBEY,Bharatiya Janata Party,380314,186,380500,1
Jharkhand,Godda,PRADIP YADAV,JVM,193458,48,193506,2
Jharkhand,Godda,FURKAN ANSARI,Indian National Congress,319739,79,319818,3
Jharkhand,Godda,MANRAJ,Bahujan Samaj Party,20865,6,20871,4
Jharkhand,Godda,SUBODH PRASAD,AJSUP,10992,6,10998,5
Jharkhand,Godda,GITA MANDAL,Communist Party of India (Marxist-Lenninist) (Liberation),4343,1,4344,6
Jharkhand,Godda,JAI SHANKAR JHA,Aam Aadmi Party,5076,4,5080,7
Jharkhand,Godda,MD. JENUL,Bahujan Mukti Party,4466,0,4466,8
Jharkhand,Godda,DAMODAR SINGH,All India Trinamool Congress,28245,1,28246,9
Jharkhand,Godda,MD. NOOR HASSAN,Samata Party,5131,1,5132,10
Jharkhand,Godda,MAHENDRA MURMU,JVD,3903,1,3904,11
Jharkhand,Godda,RAJVARDHAN AZAD,Janata Dal (United),14034,0,14034,12
Jharkhand,Godda,NAVIN CHANDRA JHA,Independent,7278,0,7278,13
Jharkhand,Godda,NIRANJAN PRASAD YADAV,Independent,9059,0,9059,14
Jharkhand,Godda,MANOJ KUMAR RAY,Independent,7447,0,7447,15
Jharkhand,Godda,SUNIL KUMAR GUPTA,Independent,22349,0,22349,16
Jharkhand,Godda,None of the Above,NOTA,12409,1,12410,17
Jharkhand,Chatra,HAJI JAINUL ABEDIN,Bahujan Samaj Party,14928,1,14929,1
Jharkhand,Chatra,DHIRAJ PRASAD SAHU,Indian National Congress,117835,1,117836,2
Jharkhand,Chatra,NAGMANI,AJSUP,35674,0,35674,3
Jharkhand,Chatra,NILAM DEVI,JVM,104176,0,104176,4
Jharkhand,Chatra,BANWARI SAW,Communist Party of India,21261,0,21261,5
Jharkhand,Chatra,SUNIL KUMAR SINGH,Bharatiya Janata Party,295857,5,295862,6
Jharkhand,Chatra,KESHWAR YADAV,Samajwadi Party,29754,0,29754,7
Jharkhand,Chatra,CHANDRADEO THAKUR,Socialist Party (India),4725,0,4725,8
Jharkhand,Chatra,NAUSHAD ALAM,All India Trinamool Congress,7841,0,7841,9
Jharkhand,Chatra,BALWANT KUMAR,Jharkhand Party,6845,0,6845,10
Jharkhand,Chatra,MAHESH SINGH YADAV,Janata Dal (United),5783,0,5783,11
Jharkhand,Chatra,MISTAR ALAM ASRAFEE,RJM,4647,0,4647,12
Jharkhand,Chatra,RAJ KUMAR PAHAN,Rashtriya Deshaj Party,10771,0,10771,13
Jharkhand,Chatra,RAMNARESH SINGH,Communist Party of India (Marxist-Lenninist) (Liberation),8341,0,8341,14
Jharkhand,Chatra,SAGAR RAM,Akhil Bharat Hindu Mahasabha,5743,0,5743,15
Jharkhand,Chatra,SIMA CHANDRAVANSI,Aam Aadmi Party,17979,1,17980,16
Jharkhand,Chatra,ANIL KUMAR ORAON,Independent,4207,2,4209,17
Jharkhand,Chatra,ASHISH BHUSHAN PATHAK,Independent,2944,0,2944,18
Jharkhand,Chatra,ROBIN SINGH,Independent,2016,0,2016,19
Jharkhand,Chatra,SUDHANSHU SUMAN,Independent,5843,0,5843,20
Jharkhand,Chatra,None of the Above,NOTA,5791,0,5791,21
Jharkhand,Kodarma,TILAKDHARI PD SINGH,Indian National Congress,60330,0,60330,1
Jharkhand,Kodarma,NAJRUL HASSAN HASHMI,AJSUP,25522,0,25522,2
Jharkhand,Kodarma,PRANAV KUMAR VERMA,JVM,160638,0,160638,3
Jharkhand,Kodarma,RAVINDRA KR. RAY,Bharatiya Janata Party,365405,5,365410,4
Jharkhand,Kodarma,BISHESHWAR PRASAD,Bahujan Samaj Party,12459,0,12459,5
Jharkhand,Kodarma,KRISHNA SINGH,Janata Dal (United),18727,0,18727,6
Jharkhand,Kodarma,JAIDEO CHAUDHARY,Samajwadi Party,7838,0,7838,7
Jharkhand,Kodarma,MD. JALIL ANSARI,National Loktantrik Party,4245,0,4245,8
Jharkhand,Kodarma,MANJU KUMARI,All India Trinamool Congress,12785,0,12785,9
Jharkhand,Kodarma,MAHENDRA RAVIDAS,Bahujan Mukti Party,6141,0,6141,10
Jharkhand,Kodarma,YOGENDRA RAM,Akhil Bharatiya Jan Sangh,4516,0,4516,11
Jharkhand,Kodarma,RAGHUNANDAN PRASAD VISHWAKARMA,All India Forward Bloc,6992,0,6992,12
Jharkhand,Kodarma,RAJKUMAR YADAV,Communist Party of India (Marxist-Lenninist) (Liberation),266756,0,266756,13
Jharkhand,Kodarma,VIJAY KUMAR CHOURASIYA,Aam Aadmi Party,11880,0,11880,14
Jharkhand,Kodarma,DR. SURAJ MANDAL,JVD,6966,0,6966,15
Jharkhand,Kodarma,KANCHAN KUMARI,Independent,20669,0,20669,16
Jharkhand,Kodarma,PHALJIT MAHTO,Independent,5996,0,5996,17
Jharkhand,Kodarma,MANOJ KUMAR,Independent,2873,0,2873,18
Jharkhand,Kodarma,RAMESHWAR PRASAD YADAV,Independent,6334,0,6334,19
Jharkhand,Kodarma,SHIVANATH SAV,Independent,11117,0,11117,20
Jharkhand,Kodarma,None of the Above,NOTA,6712,0,6712,21
Jharkhand,Giridih,UMESH CHANDRA MEHTA,AJSUP,55531,0,55531,1
Jharkhand,Giridih,KARTIK MAHTO,Bahujan Samaj Party,6341,0,6341,2
Jharkhand,Giridih,JAGARNATH MAHTO,Jharkhand Mukti Morcha,351598,2,351600,3
Jharkhand,Giridih,RAVINDRA KUMAR PANDEY,Bharatiya Janata Party,391905,8,391913,4
Jharkhand,Giridih,SABA AHMAD,JVM,57380,0,57380,5
Jharkhand,Giridih,ASHUTOSH VERMA,All India Trinamool Congress,11354,1,11355,6
Jharkhand,Giridih,GURJEET SINGH,Aam Aadmi Party,7070,1,7071,7
Jharkhand,Giridih,JALESHWAR MAHATO,Janata Dal (United),40010,0,40010,8
Jharkhand,Giridih,JEETENDRA KUMAR,Samajwadi Party,2825,0,2825,9
Jharkhand,Giridih,MRINAL KANTI DEV,Socialist Party (Lohia),1997,0,1997,10
Jharkhand,Giridih,BIDESHI MAHTO,JDP,4325,0,4325,11
Jharkhand,Giridih,SANJEEV KUMAR SINHA,All India Forward Bloc,2988,0,2988,12
Jharkhand,Giridih,SOHRAB SHAH,Bahujan Mukti Party,5072,0,5072,13
Jharkhand,Giridih,DILIP KR RAJAK,Independent,6406,0,6406,14
Jharkhand,Giridih,SHIVA MAHTO,Independent,3660,0,3660,15
Jharkhand,Giridih,SANJEEV KUMAR MAHATO,Independent,13132,0,13132,16
Jharkhand,Giridih,SAJJADUR RAB HASAMI,Independent,3512,0,3512,17
Jharkhand,Giridih,None of the Above,NOTA,4879,0,4879,18
Jharkhand,Dhanbad,AJAY KUMAR DUBEY,Indian National Congress,250534,3,250537,1
Jharkhand,Dhanbad,PASHUPATI NATH SINGH,Bharatiya Janata Party,543482,9,543491,2
Jharkhand,Dhanbad,MADAN MOHAN RAM,Bahujan Samaj Party,8454,1,8455,3
Jharkhand,Dhanbad,SAMARESH SINGH,JVM,90926,0,90926,4
Jharkhand,Dhanbad,HEMLATA S. MOHAN,AJSUP,21277,0,21277,5
Jharkhand,Dhanbad,AKLU RAM MAHTO,Samajwadi Party,4169,0,4169,6
Jharkhand,Dhanbad,AHMAD HUSSAIN ANSARI,JDP,3120,0,3120,7
Jharkhand,Dhanbad,ANAND MAHATO,Marxist Co-Ordination,110185,0,110185,8
Jharkhand,Dhanbad,KISHOR KUMAR MURMU,Bahujan Mukti Party,4531,0,4531,9
Jharkhand,Dhanbad,CHANDRA SHEKHAR DUBEY,All India Trinamool Congress,29937,0,29937,10
Jharkhand,Dhanbad,JAYANT PANDEY,All India Forward Bloc,2518,0,2518,11
Jharkhand,Dhanbad,MD. ZUBAIR,All India Minorities Front,3094,0,3094,12
Jharkhand,Dhanbad,MANTOSH KUMAR MANDAL,Amra Bangalee,3413,0,3413,13
Jharkhand,Dhanbad,RAMA KANT VERMA,Aam Aadmi Party,8948,0,8948,14
Jharkhand,Dhanbad,HIRALAL SANKHWAR,Jharkhand Party,8580,0,8580,15
Jharkhand,Dhanbad,DR. KRISHNA CHANDRA SINGHRAJ,Independent,13200,0,13200,16
Jharkhand,Dhanbad,GANPAT MAHTO,Independent,5441,0,5441,17
Jharkhand,Dhanbad,GAUTAM KUMAR MAHATO,Independent,3000,0,3000,18
Jharkhand,Dhanbad,TARCH MURMU,Independent,1190,0,1190,19
Jharkhand,Dhanbad,PARSHURAM PASWAN,Independent,1359,0,1359,20
Jharkhand,Dhanbad,PAWAN MAHATO,Independent,811,0,811,21
Jharkhand,Dhanbad,PREM PRAKASH PASWAN,Independent,1226,0,1226,22
Jharkhand,Dhanbad,BINOD SINGH,Independent,1457,0,1457,23
Jharkhand,Dhanbad,MANILAL MAHTO,Independent,1888,0,1888,24
Jharkhand,Dhanbad,MUNSHI HEMBRAM,Independent,1486,0,1486,25
Jharkhand,Dhanbad,RANBIR SINGH,Independent,1516,0,1516,26
Jharkhand,Dhanbad,RAMESH KUMAR RAY,Independent,965,0,965,27
Jharkhand,Dhanbad,RAMESH BHARATI,Independent,2052,0,2052,28
Jharkhand,Dhanbad,RITU RANI SINGH,Independent,3814,0,3814,29
Jharkhand,Dhanbad,VIJAY KANT MISHRA,Independent,1537,0,1537,30
Jharkhand,Dhanbad,SUMAN BANERJEE,Independent,2104,0,2104,31
Jharkhand,Dhanbad,None of the Above,NOTA,7675,0,7675,32
Jharkhand,Ranchi,AMITABH CHOUDHARY,JVM,67705,7,67712,1
Jharkhand,Ranchi,DURGA MUNDA,Bahujan Samaj Party,2500,2,2502,2
Jharkhand,Ranchi,RAJENDRA SINGH MUNDA,Communist Party of India  (Marxist),10177,1,10178,3
Jharkhand,Ranchi,RAM TAHAL CHOUDHARY,Bharatiya Janata Party,448617,112,448729,4
Jharkhand,Ranchi,SUDESH KUMAR MAHTO,AJSUP,142547,13,142560,5
Jharkhand,Ranchi,SUBODH KANT SAHAY,Indian National Congress,249399,27,249426,6
Jharkhand,Ranchi,AMANULLAH,Aam Aadmi Party,8493,4,8497,7
Jharkhand,Ranchi,BANDHU TIRKEY,All India Trinamool Congress,46115,11,46126,8
Jharkhand,Ranchi,BAHADUR  URAON,Communist Party of India (Marxist-Lenninist) (Liberation),3877,0,3877,9
Jharkhand,Ranchi,BISHESHWAR MAHTO,Samata Party,2130,0,2130,10
Jharkhand,Ranchi,MAN SINGH MARDI,Jharkhand Party (Naren),4239,1,4240,11
Jharkhand,Ranchi,"YUGESHWAR MARAR ""DEEN""",MMM,4409,0,4409,12
Jharkhand,Ranchi,RANJIT MAHTO,Bahujan Mukti Party,3823,0,3823,13
Jharkhand,Ranchi,RAM LAL MAHTO,SOCIALIST UNITY CENTRE OF INDIA (COMMUNIST),4190,0,4190,14
Jharkhand,Ranchi,LAL JOTINDRA DEV,AKBJHP,3411,0,3411,15
Jharkhand,Ranchi,VIKAS CHANDRA SHARMA,Communist Party of India (Marxist),14898,0,14898,16
Jharkhand,Ranchi,SURESH TOPPO,JDP,4085,0,4085,17
Jharkhand,Ranchi,ANJANI PANDEY,Independent,1250,0,1250,18
Jharkhand,Ranchi,ABUL HASAN,Independent,1219,0,1219,19
Jharkhand,Ranchi,AMIT KUMAR SINGH,Independent,1987,0,1987,20
Jharkhand,Ranchi,ARSAD AYUB,Independent,2083,0,2083,21
Jharkhand,Ranchi,KAFILUR RAHMAN,Independent,4696,0,4696,22
Jharkhand,Ranchi,CHINTAMANI MAHTO,Independent,1605,0,1605,23
Jharkhand,Ranchi,THADDEUS LAKRA,Independent,1504,0,1504,24
Jharkhand,Ranchi,BALRAM KUMAR BEDIA,Independent,2889,0,2889,25
Jharkhand,Ranchi,BIRENDRA KUMAR JAISWAL,Independent,1366,0,1366,26
Jharkhand,Ranchi,RAMPODO MAHTO,Independent,1296,0,1296,27
Jharkhand,Ranchi,SAJIYA HAIDAR,Independent,2195,0,2195,28
Jharkhand,Ranchi,None of the Above,NOTA,6900,0,6900,29
Jharkhand,Jamshedpur,AJAY KUMAR,JVM,364270,7,364277,1
Jharkhand,Jamshedpur,DAMAN CHANDRA BHAKAT,Bahujan Samaj Party,4606,0,4606,2
Jharkhand,Jamshedpur,NIROOP MAHANTY,Jharkhand Mukti Morcha,138109,0,138109,3
Jharkhand,Jamshedpur,BIDYUT BARAN MAHATO,Bharatiya Janata Party,464144,9,464153,4
Jharkhand,Jamshedpur,ANGAD MAHATO,Amra Bangalee,12632,0,12632,5
Jharkhand,Jamshedpur,KUMAR CHANDRA MARDI,Aam Aadmi Party,7144,1,7145,6
Jharkhand,Jamshedpur,JOSAI MARDI,Rashtriya Deshaj Party,5378,0,5378,7
Jharkhand,Jamshedpur,D.G.RAJA,Samajwadi Party,3414,0,3414,8
Jharkhand,Jamshedpur,SITA RAM TUDU,SOCIALIST UNITY CENTRE OF INDIA (COMMUNIST),3700,0,3700,9
Jharkhand,Jamshedpur,SEKH AKHIRUDDIN,Jharkhand Party (Naren),4822,0,4822,10
Jharkhand,Jamshedpur,UPENDRA KARMAKAR,Independent,4429,0,4429,11
Jharkhand,Jamshedpur,OM PRAKASH ANAND,Independent,5654,1,5655,12
Jharkhand,Jamshedpur,DINESH MAHATO,Independent,5300,0,5300,13
Jharkhand,Jamshedpur,MOBIN KHAN,Independent,5406,0,5406,14
Jharkhand,Jamshedpur,HARI ORAWN,Independent,4485,0,4485,15
Jharkhand,Jamshedpur,None of the Above,NOTA,15629,0,15629,16
Jharkhand,Singhbhum,CHITRASEN SINKU,Indian National Congress,111790,6,111796,1
Jharkhand,Singhbhum,DASHRATH GAGRAI,JVM,35681,0,35681,2
Jharkhand,Singhbhum,MANOHAR SINKU,Bahujan Samaj Party,9303,0,9303,3
Jharkhand,Singhbhum,LAXMAN GILUWA,Bharatiya Janata Party,303079,52,303131,4
Jharkhand,Singhbhum,GEETA KORA,JBSP,215603,4,215607,5
Jharkhand,Singhbhum,JOHN MIRAN MUNDA,All India Forward Bloc,16952,0,16952,6
Jharkhand,Singhbhum,NAVEEN MURMU,Rashtriya Deshaj Party,8607,0,8607,7
Jharkhand,Singhbhum,BUDHRAM LAGURI,Bahujan Mukti Party,8346,0,8346,8
Jharkhand,Singhbhum,RAJENDRA PURTY,Jharkhand Party,11507,0,11507,9
Jharkhand,Singhbhum,SALKHAN MURMU,JDP,25547,0,25547,10
Jharkhand,Singhbhum,RUPSINGH HEMBROM,Independent,8895,0,8895,11
Jharkhand,Singhbhum,SNEHLATA JOJO,Independent,12877,0,12877,12
Jharkhand,Singhbhum,None of the Above,NOTA,27037,0,27037,13
Jharkhand,Khunti,KARIA MUNDA,Bharatiya Janata Party,269160,25,269185,1
Jharkhand,Khunti,KALI CHARAN MUNDA,Indian National Congress,147015,2,147017,2
Jharkhand,Khunti,NEIL TIRKEY,AJSUP,27157,1,27158,3
Jharkhand,Khunti,BASANT KUMAR LONGA,JVM,24514,0,24514,4
Jharkhand,Khunti,SUBODH PURTY,Bahujan Samaj Party,6407,0,6407,5
Jharkhand,Khunti,ANOSH EKKA,Jharkhand Party,176937,0,176937,6
Jharkhand,Khunti,DAYAMANI BARLA,Aam Aadmi Party,11822,0,11822,7
Jharkhand,Khunti,NITIMA BODRA BARI,Samajwadi Party,4425,0,4425,8
Jharkhand,Khunti,BUDAY MUNDA,AKBJHP,4840,1,4841,9
Jharkhand,Khunti,MAHADEV RAVINATH PAHAN,Rashtriya Deshaj Party,13566,0,13566,10
Jharkhand,Khunti,ASRITA TUTI,Independent,4349,0,4349,11
Jharkhand,Khunti,KALYAN NAG,Independent,4958,0,4958,12
Jharkhand,Khunti,JITENDRA MANKI  ALIAS JITENDRA PRASAD MANKI,Independent,6596,0,6596,13
Jharkhand,Khunti,JAITUN TUTI,Independent,11364,0,11364,14
Jharkhand,Khunti,None of the Above,NOTA,23816,0,23816,15
Jharkhand,Lohardaga,JAYRAM INDWAR,Bahujan Samaj Party,11793,1,11794,1
Jharkhand,Lohardaga,BIRENDRA BHAGAT,JVM,26109,0,26109,2
Jharkhand,Lohardaga,RAMESHWAR ORAON,Indian National Congress,220151,26,220177,3
Jharkhand,Lohardaga,SUDARSHAN BHAGAT,Bharatiya Janata Party,226579,87,226666,4
Jharkhand,Lohardaga,CHAMRA LINDA,All India Trinamool Congress,118347,8,118355,5
Jharkhand,Lohardaga,LAL SAY KUMAR BHAGAT,Communist Party of India (Marxist-Lenninist) (Liberation),13252,0,13252,6
Jharkhand,Lohardaga,NAWAL KISHOR SINGH,Independent,5870,0,5870,7
Jharkhand,Lohardaga,MAHENDRA  ORAON,Independent,6434,2,6436,8
Jharkhand,Lohardaga,RANJIT ORAON,Independent,6034,3,6037,9
Jharkhand,Lohardaga,None of the Above,NOTA,16764,0,16764,10
Jharkhand,Palamau,GHURAN RAM,JVM,156622,210,156832,1
Jharkhand,Palamau,MANOJ KUMAR,Rashtriya Janata Dal,212357,214,212571,2
Jharkhand,Palamau,RAMPATI RANJAN,Bahujan Samaj Party,20462,19,20481,3
Jharkhand,Palamau,VISHNU DAYAL RAM,Bharatiya Janata Party,475738,775,476513,4
Jharkhand,Palamau,KAMESHWAR BAITHA,All India Trinamool Congress,37033,10,37043,5
Jharkhand,Palamau,JORAWAR RAM,Janata Dal (United),7531,7,7538,6
Jharkhand,Palamau,RAM BADAN RAM,Samajwadi Party,4972,4,4976,7
Jharkhand,Palamau,LALDEO RAM,Bahujan Mukti Party,4431,1,4432,8
Jharkhand,Palamau,SHUSHMA MEHTA,Communist Party of India (Marxist-Lenninist) (Liberation),8381,5,8386,9
Jharkhand,Palamau,ASHOK  RAM,Independent,5648,0,5648,10
Jharkhand,Palamau,RAVINDRA KUMAR RAVI,Independent,9145,0,9145,11
Jharkhand,Palamau,VINOD RAM,Independent,5872,7,5879,12
Jharkhand,Palamau,SHYAM LAL RAM,Independent,9592,0,9592,13
Jharkhand,Palamau,None of the Above,NOTA,18283,4,18287,14
Jharkhand,Hazaribagh,ARUN KUMAR MISHRA,JVM,30408,0,30408,1
Jharkhand,Hazaribagh,JAYANT SINHA,Bharatiya Janata Party,406912,19,406931,2
Jharkhand,Hazaribagh,TETRI @ SHEELA DEVI,Bahujan Samaj Party,8159,0,8159,3
Jharkhand,Hazaribagh,BHUVNESHWAR PRASAD MEHTA,Communist Party of India,30326,0,30326,4
Jharkhand,Hazaribagh,LOKNATH MAHTO,AJSUP,156186,0,156186,5
Jharkhand,Hazaribagh,SAURABH NARAIN SINGH,Indian National Congress,247798,5,247803,6
Jharkhand,Hazaribagh,AJIT KUMAR SINGH,All India Trinamool Congress,8360,0,8360,7
Jharkhand,Hazaribagh,ABDUL RAHIM,Bahujan Mukti Party,2941,0,2941,8
Jharkhand,Hazaribagh,JAVED ISLAM,Communist Party of India (Marxist-Lenninist) (Liberation),8453,0,8453,9
Jharkhand,Hazaribagh,PRAMOD KUMAR MAHTHA,pms,3076,0,3076,10
Jharkhand,Hazaribagh,MITHILESH KUMAR DANGI,Aam Aadmi Party,7140,0,7140,11
Jharkhand,Hazaribagh,RAMESHWAR RAM KUSHWAHA,All India Forward Bloc,4423,0,4423,12
Jharkhand,Hazaribagh,MO. SHANUL HAQUE,Indian Union Muslim League,3189,0,3189,13
Jharkhand,Hazaribagh,DR. DHIRENDRA KUMAR RAJ,Independent,4481,0,4481,14
Jharkhand,Hazaribagh,PRAYAG PRASAD,Independent,8085,0,8085,15
Jharkhand,Hazaribagh,BADRI GOPE,Independent,14555,0,14555,16
Jharkhand,Hazaribagh,BALDEO GANJHU,Independent,5152,0,5152,17
Jharkhand,Hazaribagh,MAHENDRA KISHOR MEHTA,Independent,3752,0,3752,18
Jharkhand,Hazaribagh,YASHPAL YADAV,Independent,3540,0,3540,19
Jharkhand,Hazaribagh,RAMAVTAR MAHTO,Independent,3365,0,3365,20
Jharkhand,Hazaribagh,None of the Above,NOTA,6827,0,6827,21
Uttarakhand,Tehri Garhwal,MALA RAJYA LAXMI SHAH,Bharatiya Janata Party,443199,3534,446733,1
Uttarakhand,Tehri Garhwal,SHIV PRASAD DEOLI,Communist Party of India  (Marxist),6546,31,6577,2
Uttarakhand,Tehri Garhwal,SHISHPAL SINGH,Bahujan Samaj Party,11389,149,11538,3
Uttarakhand,Tehri Garhwal,SAKET BAHUGUNA,Indian National Congress,252971,1259,254230,4
Uttarakhand,Tehri Garhwal,ANOOP NAUTIYAL,Aam Aadmi Party,23801,242,24043,5
Uttarakhand,Tehri Garhwal,JAPINDER SINGH,Rashtriya Lok Dal,1938,20,1958,6
Uttarakhand,Tehri Garhwal,JAUHARI LAL SUMAN(MUNI),BMNSP,875,2,877,7
Uttarakhand,Tehri Garhwal,NAVNEET SINGH GOSAIN,raup,1623,6,1629,8
Uttarakhand,Tehri Garhwal,HAJI MOHD. YOUSUF,Peace Party,893,7,900,9
Uttarakhand,Tehri Garhwal,SATENDRA SHARMA,NADP,866,12,878,10
Uttarakhand,Tehri Garhwal,GAURAV PUNDIR,Independent,2288,14,2302,11
Uttarakhand,Tehri Garhwal,JAI PRAKASH UPADHYAY,Independent,1604,15,1619,12
Uttarakhand,Tehri Garhwal,PREM SINGH YADAV,Independent,1998,9,2007,13
Uttarakhand,Tehri Garhwal,BARHM DEV JHA,Independent,1548,6,1554,14
Uttarakhand,Tehri Garhwal,RAJU MAURYA,Independent,1932,3,1935,15
Uttarakhand,Tehri Garhwal,SOHAN PAL SINGH,Independent,6668,4,6672,16
Uttarakhand,Tehri Garhwal,None of the Above,NOTA,10729,33,10762,17
Uttarakhand,Garhwal,DHEER SINGH BISHT,Bahujan Samaj Party,9231,19,9250,1
Uttarakhand,Garhwal,NARENDRA SINGH NEGI,Communist Party of India,6516,9,6525,2
Uttarakhand,Garhwal,(MAJ GEN (RETD.) ) BHUWAN CHANDRA KHANDURI (AVSM),Bharatiya Janata Party,401951,3739,405690,3
Uttarakhand,Garhwal,(DR) HARAK SINGH RAWAT,Indian National Congress,220987,177,221164,4
Uttarakhand,Garhwal,INDRESH MAIKHURI,Communist Party of India (Marxist-Lenninist) (Liberation),7466,4,7470,5
Uttarakhand,Garhwal,(DR) RAKESH SINGH,Aam Aadmi Party,6683,44,6727,6
Uttarakhand,Garhwal,ANUP NEGI,Independent,2277,2,2279,7
Uttarakhand,Garhwal,ABDUL SALAM,Independent,4502,8,4510,8
Uttarakhand,Garhwal,BHUPAL SINGH GUSAIN (UKD),Independent,6695,4,6699,9
Uttarakhand,Garhwal,RENU AGARWAL,Independent,3042,9,3051,10
Uttarakhand,Garhwal,None of the Above,NOTA,8652,7,8659,11
Uttarakhand,Almora,AJAY TAMTA,Bharatiya Janata Party,347284,902,348186,1
Uttarakhand,Almora,PRADEEP TAMTA,Indian National Congress,252416,80,252496,2
Uttarakhand,Almora,BAHADUR RAM DHAUNI,Bahujan Samaj Party,14141,9,14150,3
Uttarakhand,Almora,AMAR PRAKASH,UPP,2044,1,2045,4
Uttarakhand,Almora,BHAGAWATI PRASAD TRIKOTI,Samajwadi Party,1850,1,1851,5
Uttarakhand,Almora,VIJAY KUMAR,Communist Party of India (Marxist-Lenninist) (Liberation),2391,1,2392,6
Uttarakhand,Almora,HARISH CHANDRA ARYA,Aam Aadmi Party,7896,20,7916,7
Uttarakhand,Almora,BANSI RAM,Independent,3855,2,3857,8
Uttarakhand,Almora,SAJJAN LAL TAMTA,Independent,8385,2,8387,9
Uttarakhand,Almora,None of the Above,NOTA,15242,3,15245,10
Uttarakhand,Nainital-udhamsingh Nagar,BHAGAT SINGH KOSHYARI,Bharatiya Janata Party,635318,1451,636769,1
Uttarakhand,Nainital-udhamsingh Nagar,LAIK AHMED,Bahujan Samaj Party,59203,42,59245,2
Uttarakhand,Nainital-udhamsingh Nagar,K.C.SINGH BABA,Indian National Congress,351526,526,352052,3
Uttarakhand,Nainital-udhamsingh Nagar,AVTAR SINGH,Samajwadi Party,9821,4,9825,4
Uttarakhand,Nainital-udhamsingh Nagar,ASHARAM KASHYAP,Rashtriya Mahan Gantantra Party,1036,1,1037,5
Uttarakhand,Nainital-udhamsingh Nagar,KAILASH PANDEY,Communist Party of India (Marxist-Lenninist) (Liberation),1529,1,1530,6
Uttarakhand,Nainital-udhamsingh Nagar,KHASHTI SUYAL,BCP,802,0,802,7
Uttarakhand,Nainital-udhamsingh Nagar,BALLI SINGH CHEEMA,Aam Aadmi Party,13444,28,13472,8
Uttarakhand,Nainital-udhamsingh Nagar,RAM SINGH,Peace Party,1063,1,1064,9
Uttarakhand,Nainital-udhamsingh Nagar,D.S.RAWAL,Bharat Ki Lok Jimmedar Party,3392,0,3392,10
Uttarakhand,Nainital-udhamsingh Nagar,SHEESHPALARYA,ANC,2696,10,2706,11
Uttarakhand,Nainital-udhamsingh Nagar,KAILASH CHANDRA,Independent,1634,1,1635,12
Uttarakhand,Nainital-udhamsingh Nagar,BHAGWAN SWAROOP,Independent,1868,1,1869,13
Uttarakhand,Nainital-udhamsingh Nagar,BHUWAN CHANDRA JOSHI,Independent,3180,0,3180,14
Uttarakhand,Nainital-udhamsingh Nagar,SHAKIL AHMED,Independent,2528,1,2529,15
Uttarakhand,Nainital-udhamsingh Nagar,None of the Above,NOTA,10305,23,10328,16
Uttarakhand,Hardwar,HAJI MOHD ISLAM,Bahujan Samaj Party,113593,70,113663,1
Uttarakhand,Hardwar,RAMESH POKHRIYAL NISHANK,Bharatiya Janata Party,590831,1489,592320,2
Uttarakhand,Hardwar,RENUKA RAWAT,Indian National Congress,413951,547,414498,3
Uttarakhand,Hardwar,ANITA SAINI,Samajwadi Party,5757,8,5765,4
Uttarakhand,Hardwar,ANAND KUMAR VERMA,HKRD,708,2,710,5
Uttarakhand,Hardwar,KANCHAN CHOUDHRY,Aam Aadmi Party,18018,152,18170,6
Uttarakhand,Hardwar,JAVED,ABML(S),612,2,614,7
Uttarakhand,Hardwar,PERVEZ AQIL,All India Minorities Front,454,0,454,8
Uttarakhand,Hardwar,MUKESH SAINI,Bahujan Mukti Party,663,1,664,9
Uttarakhand,Hardwar,RAMNARESH YADAV,kajp,1116,1,1117,10
Uttarakhand,Hardwar,V. K. KAMPANI,PHRC,627,10,637,11
Uttarakhand,Hardwar,VISHAL CHAUDHARY,Shivsena,1040,3,1043,12
Uttarakhand,Hardwar,SANJAY GOYAL,NADP,915,0,915,13
Uttarakhand,Hardwar,ABDUL ALEEM,Independent,1681,1,1682,14
Uttarakhand,Hardwar,ASRAF,Independent,2523,12,2535,15
Uttarakhand,Hardwar,ISHWAR CHAND,Independent,3737,3,3740,16
Uttarakhand,Hardwar,BRIGADIER GOVIND PRASAD BARTHWAL VSM,Independent,1885,3,1888,17
Uttarakhand,Hardwar,JAI SINGH,Independent,2759,10,2769,18
Uttarakhand,Hardwar,D.D.SHARMA,Independent,2065,2,2067,19
Uttarakhand,Hardwar,PRAMOD RANA,Independent,761,4,765,20
Uttarakhand,Hardwar,MOHAR SINGH KATARIA,Independent,1051,0,1051,21
Uttarakhand,Hardwar,RAZIA BEG,Independent,3740,1,3741,22
Uttarakhand,Hardwar,RAKESH,Independent,1015,0,1015,23
Uttarakhand,Hardwar,SUNIL,Independent,820,0,820,24
Uttarakhand,Hardwar,None of the Above,NOTA,3030,19,3049,25
Andaman & Nicobar Islands,Andaman & Nicobar Islands,R.S.UMA BHARATTHY,Nationalist Congress Party,1150,1,1151,1
Andaman & Nicobar Islands,Andaman & Nicobar Islands,KULDEEP RAI SHARMA,Indian National Congress,83144,13,83157,2
Andaman & Nicobar Islands,Andaman & Nicobar Islands,GOUR CHANDRA MAJUMDER,Bahujan Samaj Party,1139,0,1139,3
Andaman & Nicobar Islands,Andaman & Nicobar Islands,K.G.DAS,Communist Party of India  (Marxist),1776,1,1777,4
Andaman & Nicobar Islands,Andaman & Nicobar Islands,BISHNU PADA RAY,Bharatiya Janata Party,90882,87,90969,5
Andaman & Nicobar Islands,Andaman & Nicobar Islands,ANITA MONDAL,All India Trinamool Congress,2283,0,2283,6
Andaman & Nicobar Islands,Andaman & Nicobar Islands,N K P NAIR,Communist Party of India (Marxist-Lenninist) (Liberation),436,0,436,7
Andaman & Nicobar Islands,Andaman & Nicobar Islands,A PANDIAN,All India Forward Bloc,225,0,225,8
Andaman & Nicobar Islands,Andaman & Nicobar Islands,RAGHUBIR SINGH,Samajwadi Party,379,0,379,9
Andaman & Nicobar Islands,Andaman & Nicobar Islands,SANJAY MESHACK,Aam Aadmi Party,3725,12,3737,10
Andaman & Nicobar Islands,Andaman & Nicobar Islands,N KANNAN,Independent,314,0,314,11
Andaman & Nicobar Islands,Andaman & Nicobar Islands,V V KHALID,Independent,429,0,429,12
Andaman & Nicobar Islands,Andaman & Nicobar Islands,PRAKASH MINJ,Independent,1587,0,1587,13
Andaman & Nicobar Islands,Andaman & Nicobar Islands,C G SAJI KUMAR,Independent,334,0,334,14
Andaman & Nicobar Islands,Andaman & Nicobar Islands,SARAVANAN,Independent,847,0,847,15
Andaman & Nicobar Islands,Andaman & Nicobar Islands,None of the Above,NOTA,1563,1,1564,16
Chandigarh,CHANDIGARH,KIRRON KHER ,Bharatiya Janata Party,191295,67,191362,1
Chandigarh,CHANDIGARH,JANNAT JAHAN-UL-HAQ (NAINA),Bahujan Samaj Party,15934,0,15934,2
Chandigarh,CHANDIGARH,PAWAN KUMAR BANSAL,Indian National Congress,121700,20,121720,3
Chandigarh,CHANDIGARH,KAWALJIT SINGH,Communist Party of India (Marxist-Lenninist) (Liberation),1968,0,1968,4
Chandigarh,CHANDIGARH,KHEM LAL BANSAL,IVD,640,0,640,5
Chandigarh,CHANDIGARH,GULKIRAT KAUR PANAG (GUL PANAG),Aam Aadmi Party,108636,43,108679,6
Chandigarh,CHANDIGARH,DHARMENDER SINGH,HEP,566,0,566,7
Chandigarh,CHANDIGARH,SURENDER KUMAR,Bahujan Mukti Party,550,0,550,8
Chandigarh,CHANDIGARH,SURINDER BHARDWAJ,Janata Dal (United),434,0,434,9
Chandigarh,CHANDIGARH,AJAY SINGLA,Independent,660,0,660,10
Chandigarh,CHANDIGARH,AMARJIT KAUR,Independent,397,0,397,11
Chandigarh,CHANDIGARH,JASMER SINGH,Independent,389,0,389,12
Chandigarh,CHANDIGARH,DEEPAK SHUKLA,Independent,613,0,613,13
Chandigarh,CHANDIGARH,PAWAN KUMAR SHARMA,Independent,997,0,997,14
Chandigarh,CHANDIGARH,RAMESH CHANDER,Independent,743,0,743,15
Chandigarh,CHANDIGARH,REENA SHARMA,Independent,2643,0,2643,16
Chandigarh,CHANDIGARH,SHAMSHER SINGH,Independent,2054,0,2054,17
Chandigarh,CHANDIGARH,None of the Above,NOTA,3105,1,3106,18
Dadra & Nagar Haveli,Dadar & Nagar Haveli,KHULAT JANIYABHAI CHANDUBHAI,Nationalist Congress Party,1611,0,1611,1
Dadra & Nagar Haveli,Dadar & Nagar Haveli,DELKAR MOHANBHAI SANJIBHAI,Indian National Congress,74576,0,74576,2
Dadra & Nagar Haveli,Dadar & Nagar Haveli,PATEL NATUBHAI GOMANBHAI,Bharatiya Janata Party,80790,0,80790,3
Dadra & Nagar Haveli,Dadar & Nagar Haveli,PATEL HEMANTBHAI KESHAVBHAI,Bahujan Samaj Party,982,0,982,4
Dadra & Nagar Haveli,Dadar & Nagar Haveli,KISHAN NATHU GHUTIYA,Shivsena,378,0,378,5
Dadra & Nagar Haveli,Dadar & Nagar Haveli,PATEL CHHOTUBHAI BABUBHAI,Aam Aadmi Party,621,0,621,6
Dadra & Nagar Haveli,Dadar & Nagar Haveli,VIJAYBHAI NATHUBHAI BHOYA,Janata Dal (United),232,0,232,7
Dadra & Nagar Haveli,Dadar & Nagar Haveli,UMEDBHAI LALLUBHAI PATEL,Bahujan Mukti Party,348,0,348,8
Dadra & Nagar Haveli,Dadar & Nagar Haveli,KAMUBEN KHALPABHAI PATEL,Independent,418,0,418,9
Dadra & Nagar Haveli,Dadar & Nagar Haveli,PRAKASH VANSHA KHANVELKAR,Independent,1214,0,1214,10
Dadra & Nagar Haveli,Dadar & Nagar Haveli,BHURKUD DILIPBHAI NAVJIBHAI,Independent,1154,0,1154,11
Dadra & Nagar Haveli,Dadar & Nagar Haveli,None of the Above,NOTA,2962,0,2962,12
Daman & Diu,Daman & diu,KETAN DAHYABHAI PATEL,Indian National Congress,37737,1,37738,1
Daman & Diu,Daman & diu,PATEL LALUBHAI BABUBHAI,Bharatiya Janata Party,46956,4,46960,2
Daman & Diu,Daman & diu,BHAVESH PATEL,Bahujan Samaj Party,490,0,490,3
Daman & Diu,Daman & diu,KESSUR GOAN,Aam Aadmi Party,729,0,729,4
Daman & Diu,Daman & diu,None of the Above,NOTA,1316,0,1316,5
NCT OF Delhi,CHANDNI CHOWK                 ,ASHUTOSH,Aam Aadmi Party,301397,221,301618,1
NCT OF Delhi,CHANDNI CHOWK                 ,KAPIL SIBAL,Indian National Congress,175906,300,176206,2
NCT OF Delhi,CHANDNI CHOWK                 ,NARENDRA KUMAR PANDEY,Bahujan Samaj Party,7730,16,7746,3
NCT OF Delhi,CHANDNI CHOWK                 ,DR. HARSH VARDHAN,Bharatiya Janata Party,436380,1558,437938,4
NCT OF Delhi,CHANDNI CHOWK                 ,AJAY KUMAR KHEMKA,kajp,1643,0,1643,5
NCT OF Delhi,CHANDNI CHOWK                 ,MD. AFAQ,Jai Maha Bharath Party,251,0,251,6
NCT OF Delhi,CHANDNI CHOWK                 ,ALTAF HUSAIN,bjdi,270,2,272,7
NCT OF Delhi,CHANDNI CHOWK                 ,JAGJEET SINGH ,BGTD,290,0,290,8
NCT OF Delhi,CHANDNI CHOWK                 ,JAGMOHAN SINGH BAKSHI,ATBP,1553,0,1553,9
NCT OF Delhi,CHANDNI CHOWK                 , DR. TARUN KUMAR,Vishva Shakti Party,263,0,263,10
NCT OF Delhi,CHANDNI CHOWK                 ,TARIQ MIRZA,Republican Party of India (A),253,0,253,11
NCT OF Delhi,CHANDNI CHOWK                 ,DHAN RAJ CHAUHAN,NADP,308,0,308,12
NCT OF Delhi,CHANDNI CHOWK                 ,MOHD. MURSALEEN,Peace Party,537,1,538,13
NCT OF Delhi,CHANDNI CHOWK                 ,MUSARRAT JAHAN,RJ,591,1,592,14
NCT OF Delhi,CHANDNI CHOWK                 ,RASHMI KASHYAP,BPC,537,1,538,15
NCT OF Delhi,CHANDNI CHOWK                 ,SANJAY GANDHI,BRAVP,3390,0,3390,16
NCT OF Delhi,CHANDNI CHOWK                 ,HARIOM SHARMA,All India Trinamool Congress,3530,1,3531,17
NCT OF Delhi,CHANDNI CHOWK                 , ABDUL AMIR AMIRO,Independent,1765,0,1765,18
NCT OF Delhi,CHANDNI CHOWK                 ,ASHUTOSH,Independent,4503,2,4505,19
NCT OF Delhi,CHANDNI CHOWK                 ,GAGAN RASTOGI,Independent,1423,0,1423,20
NCT OF Delhi,CHANDNI CHOWK                 ,DILDAR HUSSAIN BEG,Independent,28605,0,28605,21
NCT OF Delhi,CHANDNI CHOWK                 ,BALRAM BARI,Independent,599,3,602,22
NCT OF Delhi,CHANDNI CHOWK                 ,BIR SINGH SONI,Independent,881,0,881,23
NCT OF Delhi,CHANDNI CHOWK                 ,VIJAY SHANKER CHAUBEY,Independent,1829,0,1829,24
NCT OF Delhi,CHANDNI CHOWK                 ,SURENDER SINGH,Independent,789,0,789,25
NCT OF Delhi,CHANDNI CHOWK                 ,None of the Above,NOTA,4522,12,4534,26
NCT OF Delhi,NORTH EAST DELHI              ,ABDUL SAMI SALMANI,Bahujan Samaj Party,28011,124,28135,1
NCT OF Delhi,NORTH EAST DELHI              ,ANAND KUMAR,Aam Aadmi Party,451823,218,452041,2
NCT OF Delhi,NORTH EAST DELHI              ,JAI PARKASH AGARWAL,Indian National Congress,214401,391,214792,3
NCT OF Delhi,NORTH EAST DELHI              ,MANOJ TIWARI,Bharatiya Janata Party,593346,2779,596125,4
NCT OF Delhi,NORTH EAST DELHI              ,A.K. AGGARWAL,Agar Jan Party,3185,6,3191,5
NCT OF Delhi,NORTH EAST DELHI              ,OM DUTT SHARMA,Shivsena,657,1,658,6
NCT OF Delhi,NORTH EAST DELHI              ,DHARAMVEER SINGH,REP,601,0,601,7
NCT OF Delhi,NORTH EAST DELHI              ,PROF. NARENDERA SHARMA,SOCIALIST UNITY CENTRE OF INDIA (COMMUNIST),506,2,508,8
NCT OF Delhi,NORTH EAST DELHI              ,PRADESH KUMAR,ANC,488,1,489,9
NCT OF Delhi,NORTH EAST DELHI              ,MOHD. ARIF SIDDIQUE,All India Trinamool Congress,783,1,784,10
NCT OF Delhi,NORTH EAST DELHI              ,RAMESH SINGH SIRAL,NADP,465,0,465,11
NCT OF Delhi,NORTH EAST DELHI              ,RAJAN LAL,Bharatiya Republican Paksha,504,0,504,12
NCT OF Delhi,NORTH EAST DELHI              ,ROSHAN ALI,National Loktantrik Party,745,0,745,13
NCT OF Delhi,NORTH EAST DELHI              ,VINAY,BSKP,818,0,818,14
NCT OF Delhi,NORTH EAST DELHI              ,MOHD. HASNAN KHAN,Jammu & Kashmir National Panthers Party,1257,0,1257,15
NCT OF Delhi,NORTH EAST DELHI              ,AMIT KUMAR SHARMA,Independent,1886,6,1892,16
NCT OF Delhi,NORTH EAST DELHI              ,ALI HUSAN,Independent,1695,0,1695,17
NCT OF Delhi,NORTH EAST DELHI              ,DAN BAHADUR YADAV,Independent,1921,0,1921,18
NCT OF Delhi,NORTH EAST DELHI              ,DINESH PAL SINGH,Independent,1263,0,1263,19
NCT OF Delhi,NORTH EAST DELHI              ,H.K. MAHENDRU,Independent,2419,0,2419,20
NCT OF Delhi,NORTH EAST DELHI              ,MUKESH KUMAR ARORA,Independent,1669,0,1669,21
NCT OF Delhi,NORTH EAST DELHI              ,MOHD. HASNAIN,Independent,878,1,879,22
NCT OF Delhi,NORTH EAST DELHI              ,HARSH KUMAR,Independent,663,0,663,23
NCT OF Delhi,NORTH EAST DELHI              ,None of the Above,NOTA,3812,12,3824,24
NCT OF Delhi,EAST DELHI                    ,MAHEISH GIRRI,Bharatiya Janata Party,571567,635,572202,1
NCT OF Delhi,EAST DELHI                    ,MOHAMMAD SHAKEEL SAIFI,Bahujan Samaj Party,18544,31,18575,2
NCT OF Delhi,EAST DELHI                    ,RAJMOHAN GANDHI,Aam Aadmi Party,381642,97,381739,3
NCT OF Delhi,EAST DELHI                    ,SANDEEP DIKSHIT,Indian National Congress,203099,141,203240,4
NCT OF Delhi,EAST DELHI                    ,ARUN THAKUR,SPP,1708,0,1708,5
NCT OF Delhi,EAST DELHI                    ,OMPAL SINGH,kajp,349,0,349,6
NCT OF Delhi,EAST DELHI                    ,JAI RAM LAL,Jammu & Kashmir National Panthers Party,668,0,668,7
NCT OF Delhi,EAST DELHI                    ,DR. NABHIT KAPUR,NADP,210,0,210,8
NCT OF Delhi,EAST DELHI                    ,MOHD NASEER,Peace Party,339,0,339,9
NCT OF Delhi,EAST DELHI                    ,PRAVEEN KUMAR,BJM,325,0,325,10
NCT OF Delhi,EAST DELHI                    ,PREM SINGH,Socialist Party (India),761,0,761,11
NCT OF Delhi,EAST DELHI                    ,MANJU CHHIBBER,Republican Party of India (A),402,0,402,12
NCT OF Delhi,EAST DELHI                    ,RAJESH,ANC,420,2,422,13
NCT OF Delhi,EAST DELHI                    ,RAM BRIKSH MALL,HND,527,0,527,14
NCT OF Delhi,EAST DELHI                    ,VIRENDRA MAYER,Samajwadi Janata Party (Rashtriya),395,0,395,15
NCT OF Delhi,EAST DELHI                    ,SHAKEEL AHMED,Jai Maha Bharath Party,1515,0,1515,16
NCT OF Delhi,EAST DELHI                    ,MOHD SHAHID SIDDIQUI,All India Trinamool Congress,3894,0,3894,17
NCT OF Delhi,EAST DELHI                    ,KUMAR VIVEK GAUTAM,Independent,978,0,978,18
NCT OF Delhi,EAST DELHI                    ,JAGANNATH TIWARI,Independent,1153,0,1153,19
NCT OF Delhi,EAST DELHI                    ,DEEPAK KUMAR,Independent,674,0,674,20
NCT OF Delhi,EAST DELHI                    ,PADAM CHAND,Independent,404,0,404,21
NCT OF Delhi,EAST DELHI                    ,MOHAMMED NAEEM,Independent,466,0,466,22
NCT OF Delhi,EAST DELHI                    ,MANJEET SINGH,Independent,415,0,415,23
NCT OF Delhi,EAST DELHI                    ,None of the Above,NOTA,4973,2,4975,24
NCT OF Delhi,NEW DELHI                     ,AJAY MAKAN,Indian National Congress,182627,266,182893,1
NCT OF Delhi,NEW DELHI                     ,ASHISH KHETAN,Aam Aadmi Party,290515,127,290642,2
NCT OF Delhi,NEW DELHI                     ,MEENAKASHI LEKHI,Bharatiya Janata Party,452480,870,453350,3
NCT OF Delhi,NEW DELHI                     ,SOLOMON GEORGE,Bahujan Samaj Party,6075,13,6088,4
NCT OF Delhi,NEW DELHI                     ,DEVI SINGH,RaJPa,217,0,217,5
NCT OF Delhi,NEW DELHI                     ,DHEERAJ PURI,Shivsena,347,0,347,6
NCT OF Delhi,NEW DELHI                     ,NAVEEN CHANDRA,NADP,199,0,199,7
NCT OF Delhi,NEW DELHI                     ,PRADEEP VARMA,BVLP,161,0,161,8
NCT OF Delhi,NEW DELHI                     ,BISWAJIT RANJIT CHATTERJEE,All India Trinamool Congress,908,1,909,9
NCT OF Delhi,NEW DELHI                     ,MEENA SINGLA,PHRC,202,3,205,10
NCT OF Delhi,NEW DELHI                     ,RAMANUJ PATEL,SPP,158,0,158,11
NCT OF Delhi,NEW DELHI                     ,LAKSHMI NARAYAN,BHBP,365,1,366,12
NCT OF Delhi,NEW DELHI                     ,SWADESH OHRI,ATBP,580,2,582,13
NCT OF Delhi,NEW DELHI                     ,SUJEET JHA,bjdi,387,1,388,14
NCT OF Delhi,NEW DELHI                     ,SUNITA CHAUDHARY,Jammu & Kashmir National Panthers Party,528,0,528,15
NCT OF Delhi,NEW DELHI                     ,ANJUMAN AGNIHOTRI,Independent,887,0,887,16
NCT OF Delhi,NEW DELHI                     ,GHANSHYAM DASS,Independent,862,0,862,17
NCT OF Delhi,NEW DELHI                     ,DAL CHAND,Independent,662,0,662,18
NCT OF Delhi,NEW DELHI                     ,NARENDRA SINGH RAWAT,Independent,686,1,687,19
NCT OF Delhi,NEW DELHI                     ,NIKHIL SABLANIA,Independent,444,0,444,20
NCT OF Delhi,NEW DELHI                     ,PADMAJA KANDUKURI,Independent,213,0,213,21
NCT OF Delhi,NEW DELHI                     ,RATHEESH,Independent,532,0,532,22
NCT OF Delhi,NEW DELHI                     ,RAVI KUMAR GUPTA,Independent,20026,2,20028,23
NCT OF Delhi,NEW DELHI                     ,RUBINA KHAN,Independent,1260,0,1260,24
NCT OF Delhi,NEW DELHI                     ,LUKMAN KHAN,Independent,203,0,203,25
NCT OF Delhi,NEW DELHI                     ,VISHAL KHOSLA,Independent,298,0,298,26
NCT OF Delhi,NEW DELHI                     ,VED PRAKASH,Independent,186,0,186,27
NCT OF Delhi,NEW DELHI                     ,K P SANKARAN MENON,Independent,499,0,499,28
NCT OF Delhi,NEW DELHI                     ,HARKRISHAN DAS NIJHAWAN,Independent,429,0,429,29
NCT OF Delhi,NEW DELHI                     ,None of the Above,NOTA,5583,6,5589,30
NCT OF Delhi,NORTH WEST DELHI              ,UDIT RAJ,Bharatiya Janata Party,627529,2331,629860,1
NCT OF Delhi,NORTH WEST DELHI              ,KRISHNA TIRATH,Indian National Congress,157242,226,157468,2
NCT OF Delhi,NORTH WEST DELHI              ,BASANT PANWAR,Bahujan Samaj Party,21446,39,21485,3
NCT OF Delhi,NORTH WEST DELHI              ,RAKHI BIRLA,Aam Aadmi Party,522842,216,523058,4
NCT OF Delhi,NORTH WEST DELHI              ,INDER SINGH SANSI,Aa S P,1749,0,1749,5
NCT OF Delhi,NORTH WEST DELHI              ,DHARAMRAJ,BPC,1677,3,1680,6
NCT OF Delhi,NORTH WEST DELHI              ,RAJESH KUMAR,Rashtriya Bahujan Hitay Party,538,7,545,7
NCT OF Delhi,NORTH WEST DELHI              ,VIJAY KUMAR,Republican Party of India (A),661,1,662,8
NCT OF Delhi,NORTH WEST DELHI              ,KAMINI KAUR,Independent,651,15,666,9
NCT OF Delhi,NORTH WEST DELHI              ,JODHRAJ PAHARIA,Independent,2277,2,2279,10
NCT OF Delhi,NORTH WEST DELHI              ,BHUP SINGH,Independent,1106,1,1107,11
NCT OF Delhi,NORTH WEST DELHI              ,RAM KARAN SAURAN,Independent,1619,2,1621,12
NCT OF Delhi,NORTH WEST DELHI              ,SHAILENDER KUMAR,Independent,3446,0,3446,13
NCT OF Delhi,NORTH WEST DELHI              ,SUNIL CHHIKARA,Independent,1583,1,1584,14
NCT OF Delhi,NORTH WEST DELHI              ,None of the Above,NOTA,8815,11,8826,15
NCT OF Delhi,WEST DELHI                    ,JARNAIL SINGH,Aam Aadmi Party,382610,199,382809,1
NCT OF Delhi,WEST DELHI                    ,PARVESH SAHIB SINGH VERMA,Bharatiya Janata Party,649542,1853,651395,2
NCT OF Delhi,WEST DELHI                    ,MAHABAL MISHRA,Indian National Congress,193034,232,193266,3
NCT OF Delhi,WEST DELHI                    ,RAJ PAL SINGH,Bahujan Samaj Party,8687,20,8707,4
NCT OF Delhi,WEST DELHI                    ,UDAY KUMAR SINGH KUSHWAHA,Bahujan Mukti Party,805,0,805,5
NCT OF Delhi,WEST DELHI                    ,KARAM CHAND LATHWAL,BPC,353,0,353,6
NCT OF Delhi,WEST DELHI                    ,CHARAN JEET SINGH KHALSA,All India Forward Bloc,450,1,451,7
NCT OF Delhi,WEST DELHI                    ,DINESH KUMAR KUSHWAHA,ABSP,651,0,651,8
NCT OF Delhi,WEST DELHI                    ,DEEPAK KUMAR,Rashtriya Janadhikar Party,415,0,415,9
NCT OF Delhi,WEST DELHI                    ,RAKESH KUMAR,bjdi,456,2,458,10
NCT OF Delhi,WEST DELHI                    ,HAR GOBIND ARORA,Shivsena,697,6,703,11
NCT OF Delhi,WEST DELHI                    ,ISTAK KHAN,Independent,986,2,988,12
NCT OF Delhi,WEST DELHI                    ,JARNAIL SINGH,Independent,5957,3,5960,13
NCT OF Delhi,WEST DELHI                    ,JARNAIL SINGH,Independent,84722,0,84722,14
NCT OF Delhi,WEST DELHI                    ,BABU SINGH DUKHIYA,Independent,1654,0,1654,15
NCT OF Delhi,WEST DELHI                    ,VIRENDER MOHAN VATS,Independent,3078,0,3078,16
NCT OF Delhi,WEST DELHI                    ,SUNIL SOURABH,Independent,3624,0,3624,17
NCT OF Delhi,WEST DELHI                    ,None of the Above,NOTA,7924,8,7932,18
NCT OF Delhi,SOUTH DELHI                   ,COL DEVINDER SEHRAWAT,Aam Aadmi Party,390858,122,390980,1
NCT OF Delhi,SOUTH DELHI                   ,RAMESH KUMAR,Indian National Congress,125061,152,125213,2
NCT OF Delhi,SOUTH DELHI                   ,RAMESH BIDHURI,Bharatiya Janata Party,497151,829,497980,3
NCT OF Delhi,SOUTH DELHI                   ,SHRICHAND TANWAR,Communist Party of India,4474,1,4475,4
NCT OF Delhi,SOUTH DELHI                   ,SANJAY KUMAR RAI,Bahujan Samaj Party,10861,12,10873,5
NCT OF Delhi,SOUTH DELHI                   ,CHO. OMBIR SINGH NAUGHWAR,BHBP,301,2,303,6
NCT OF Delhi,SOUTH DELHI                   ,MOHAN KANUGA,Jammu & Kashmir National Panthers Party,561,0,561,7
NCT OF Delhi,SOUTH DELHI                   ,SREERUPA MITRA CHAUDHURY,All India Trinamool Congress,802,1,803,8
NCT OF Delhi,SOUTH DELHI                   ,HAFIZ MUSTAQ,Jan Samanta Party,357,0,357,9
NCT OF Delhi,SOUTH DELHI                   ,KIRAN PAL SINGH,Independent,314,0,314,10
NCT OF Delhi,SOUTH DELHI                   ,D. K. CHOPRA,Independent,410,2,412,11
NCT OF Delhi,SOUTH DELHI                   ,TEJ PAL SINGH,Independent,1214,1,1215,12
NCT OF Delhi,SOUTH DELHI                   ,DR. DUSMANTA KUMAR GIRI,Independent,556,4,560,13
NCT OF Delhi,SOUTH DELHI                   ,NARESH KUMAR CHANDALIYA,Independent,913,0,913,14
NCT OF Delhi,SOUTH DELHI                   ,RAKESH KUMAR,Independent,1071,0,1071,15
NCT OF Delhi,SOUTH DELHI                   ,RUBY YADAV,Independent,56747,2,56749,16
NCT OF Delhi,SOUTH DELHI                   ,SHAHID,Independent,2841,0,2841,17
NCT OF Delhi,SOUTH DELHI                   ,SUNIL KUMAR,Independent,1140,0,1140,18
NCT OF Delhi,SOUTH DELHI                   ,SUMANT KUMAR,Independent,1640,0,1640,19
NCT OF Delhi,SOUTH DELHI                   ,None of the Above,NOTA,4005,5,4010,20
Lakshadweep,Lakshadweep,DR.ABDUL MUNEER,Communist Party of India  (Marxist),465,0,465,1
Lakshadweep,Lakshadweep,NAJMUDHEEN C.T,Communist Party of India,181,0,181,2
Lakshadweep,Lakshadweep,MOHAMMED FAIZAL P.P.,Nationalist Congress Party,21665,0,21665,3
Lakshadweep,Lakshadweep,M.P. SAYED MOHAMMED KOYA,Bharatiya Janata Party,187,0,187,4
Lakshadweep,Lakshadweep,HAMDULLAH SAYEED,Indian National Congress,20130,0,20130,5
Lakshadweep,Lakshadweep,KOMALAM KOYA,Samajwadi Party,488,0,488,6
Lakshadweep,Lakshadweep,None of the Above,NOTA,123,0,123,7
Puducherry,Puducherry,R.K.R. ANANTHARAMAN,Pattali Makkal Katchi,22745,9,22754,1
Puducherry,Puducherry,R. RADHAKRISHNAN,AINRC,255732,94,255826,2
Puducherry,Puducherry,M.V. OMALINGAM,All India Anna Dravida Munnetra Kazhagam,132640,17,132657,3
Puducherry,Puducherry,S. KRISHNAMOORTHY,Bahujan Samaj Party,2060,0,2060,4
Puducherry,Puducherry,V. NARAYANASAMY,Indian National Congress,194873,99,194972,5
Puducherry,Puducherry,A.M.H. NAZEEM,Dravida Munnetra Kazhagam,60543,37,60580,6
Puducherry,Puducherry,R. VISWANATHAN,Communist Party of India,12706,3,12709,7
Puducherry,Puducherry,S. CHITRAKALA,Janata Dal (United),308,1,309,8
Puducherry,Puducherry,G. PALANI,Communist Party of India (Marxist-Lenninist) (Liberation),437,1,438,9
Puducherry,Puducherry,MARIE UTHRIANATHAN,Samata Party,366,0,366,10
Puducherry,Puducherry,DR. V. RANGARAJAN,Aam Aadmi Party,8303,4,8307,11
Puducherry,Puducherry,P. ASARAVEL,Independent,3472,0,3472,12
Puducherry,Puducherry,K. RAMADASS,Independent,1236,0,1236,13
Puducherry,Puducherry,PROFESSOR M. RAMADASS,Independent,2493,1,2494,14
Puducherry,Puducherry,RAMAMURTHI,Independent,1442,0,1442,15
Puducherry,Puducherry,S. EZHILARASAN,Independent,1777,0,1777,16
Puducherry,Puducherry,KALIAYAMURTHY,Independent,747,0,747,17
Puducherry,Puducherry,SANJIVGANTHI .S,Independent,5896,0,5896,18
Puducherry,Puducherry,G. SHANMUGAM,Independent,1726,0,1726,19
Puducherry,Puducherry,M. CHITTIBABU,Independent,1340,0,1340,20
Puducherry,Puducherry,S. SUDARSANAN,Independent,1270,0,1270,21
Puducherry,Puducherry,G. SUTHA,Independent,467,0,467,22
Puducherry,Puducherry,I. SENTHIL KUMAR,Independent,477,0,477,23
Puducherry,Puducherry,J. DHANDAPANI,Independent,1144,0,1144,24
Puducherry,Puducherry,P. DHANARASU @ MATHIMAHARAJA,Independent,198,0,198,25
Puducherry,Puducherry,P. BAKKIARAJ,Independent,610,0,610,26
Puducherry,Puducherry,PUVALA NAGESWARA RAO,Independent,465,0,465,27
Puducherry,Puducherry,K. MANJINI,Independent,767,0,767,28
Puducherry,Puducherry,R. VALAVAN,Independent,497,0,497,29
Puducherry,Puducherry,V. VIJAYA,Independent,746,0,746,30
Puducherry,Puducherry,None of the Above,NOTA,22267,1,22268,31